source,Clone,TRNO,EXCODE,HWAMS,HWAMM,LAIXS,LAIXM,CWAMS,CWAMM,HWAMMS,CWAMMS,LAIXMS
1,IITA-TMS-IBA000070,1,UYAB1901CS,31298,12507,4.9,6,14390,4729,-18791,-9661,1.1
1,IITA-TMS-IBA30572,2,UYAB1901CS,28527,6274,4.9,3,15523,5089,-22253,-10434,-1.9
1,IITA-TMS-IBA980581,3,UYAB1901CS,33598,11533,4.9,6,13612,8870,-22065,-4742,1.1
1,IITA-TMS-IBA982101,4,UYAB1901CS,31893,10920,4.8,4,13691,7715,-20973,-5976,-0.8
1,TMEB419,5,UYAB1901CS,26623,8916,5.1,4,14589,4370,-17707,-10219,-1.1
1,TMS13F1021P0008,6,UYAB1901CS,31960,8067,4.9,5,13566,8115,-23893,-5451,0.0999999999999996
1,TMS13F1049P0001,7,UYAB1901CS,24031,10512,3.5,2,13397,6135,-13519,-7262,-1.5
1,TMS13F1114P0001,8,UYAB1901CS,31040,7759,5,5,14695,4427,-23281,-10268,0
1,TMS13F1126P0003,9,UYAB1901CS,23011,5977,5.2,4,19775,2427,-17034,-17348,-1.2
1,TMS13F1182P0002,10,UYAB1901CS,31435,8533,4.7,6,11338,6000,-22902,-5338,1.3
1,TMS13F1304P0003,11,UYAB1901CS,26322,12525,3.4,3,9268,3740,-13797,-5528,-0.4
1,TMS13F1315P0008,12,UYAB1901CS,26658,5640,4.7,2,16786,4323,-21018,-12463,-2.7
1,TMS13F1376P0018,13,UYAB1901CS,26857,13900,3.8,NA,9098,4562,-12957,-4536,NA
1,TMS13F1400P0001,14,UYAB1901CS,30656,7969,4.9,4,14320,4448,-22687,-9872,-0.9
1,TMS13F1461P0002,15,UYAB1901CS,30878,7804,4.9,6,13907,6260,-23074,-7647,1.1
1,TMS13F2061P0005,16,UYAB1901CS,29278,4764,4.9,4,15249,3562,-24514,-11687,-0.9
1,TMS13F2207P0001,17,UYAB1901CS,33173,11313,4.8,6,12723,7052,-21860,-5671,1.2
1,TMS14F1001P0004,18,UYAB1901CS,30738,5800,4.8,4,14080,3698,-24938,-10382,-0.8
1,TMS14F1013P0007,19,UYAB1901CS,29986,11555,4.6,4,11040,6604,-18431,-4436,-0.6
1,TMS14F1014P0016,20,UYAB1901CS,27071,8629,4.4,2,12481,4229,-18442,-8252,-2.4
1,TMS14F1014P0017,21,UYAB1901CS,28550,9921,4.9,2,14976,4490,-18629,-10486,-2.9
1,TMS14F1016P0006,22,UYAB1901CS,32306,8170,4.9,16,13235,3771,-24136,-9464,11.1
1,TMS14F1019P0015,23,UYAB1901CS,29822,9254,4.8,3,12993,3323,-20568,-9670,-1.8
1,TMS14F1022P0003,24,UYAB1901CS,19860,8741,2.5,3,12766,3823,-11119,-8943,0.5
1,TMS14F1022P0006,25,UYAB1901CS,31850,4682,4.8,10,13070,2896,-27168,-10174,5.2
1,TMS14F1035P0004,26,UYAB1901CS,25837,9301,5.1,6,18175,3510,-16536,-14665,0.9
1,TMS14F1035P0007,27,UYAB1901CS,30320,7294,4.8,7,11575,4010,-23026,-7565,2.2
1,TMS14F1036P0007,28,UYAB1901CS,31168,10955,4.9,7,13378,5135,-20213,-8243,2.1
1,TMS14F1049P0001,29,UYAB1901CS,32784,5659,4.8,7,13304,2885,-27125,-10419,2.2
1,TMS14F1098P0013,30,UYAB1901CS,30754,11621,4.9,5,14377,5365,-19133,-9012,0.0999999999999996
1,TMS14F1120P0003,31,UYAB1901CS,27760,9562,5.1,5,16821,9438,-18198,-7383,-0.0999999999999996
1,TMS14F1125P0010,32,UYAB1901CS,28317,8717,5,4,16342,4875,-19600,-11467,-1
1,TMS14F1131P0001,33,UYAB1901CS,28589,8332,5.1,3,15568,3760,-20257,-11808,-2.1
1,TMS14F1146P0002,34,UYAB1901CS,29903,11907,4.7,NA,9871,7125,-17996,-2746,NA
1,TMS14F1159P0003,35,UYAB1901CS,29777,8694,4.9,4,13505,4177,-21083,-9328,-0.9
1,TMS14F1194P0002,36,UYAB1901CS,29384,9571,4.3,NA,9537,3604,-19813,-5933,NA
1,TMS14F1195P0004,37,UYAB1901CS,22525,10319,3.6,2,14109,5656,-12206,-8453,-1.6
1,TMS14F1195P0005,38,UYAB1901CS,21280,7242,5.2,5,20924,4677,-14038,-16247,-0.2
1,TMS14F1196P0003,39,UYAB1901CS,30359,7253,4.7,2,12800,2781,-23106,-10019,-2.7
1,TMS14F1208P0007,40,UYAB1901CS,27538,7058,5.1,7,16283,4469,-20480,-11814,1.9
1,TMS14F1223P0007,41,UYAB1901CS,30190,10890,5,4,14508,3021,-19300,-11487,-1
1,TMS14F1224P0004,42,UYAB1901CS,19940,3236,5.1,2,22411,3240,-16704,-19171,-3.1
1,TMS14F1262P0002,43,UYAB1901CS,25590,10853,4.9,5,17665,3188,-14737,-14477,0.0999999999999996
1,TMS14F1278P0003,44,UYAB1901CS,20569,11563,4.6,3,17761,4010,-9006,-13751,-1.6
1,TMS14F1285P0006,45,UYAB1901CS,28149,8929,4.3,2,11116,4479,-19220,-6637,-2.3
1,TMS14F1285P0017,46,UYAB1901CS,31188,10209,4.8,NA,10160,5635,-20979,-4525,NA
1,TMS14F1287P0008,47,UYAB1901CS,30860,8607,4.7,8,10638,4125,-22253,-6513,3.3
1,TMS14F1288P0008,48,UYAB1901CS,20526,7132,2.1,1,8816,4479,-13394,-4337,-1.1
1,TMS14F1291P0003,49,UYAB1901CS,30393,6426,4.7,NA,9994,3281,-23967,-6713,NA
1,TMS14F1291P0011,50,UYAB1901CS,30881,6336,4.8,NA,10477,1479,-24545,-8998,NA
1,TMS14F1291P0012,51,UYAB1901CS,29629,10386,5,8,15563,4094,-19243,-11469,3
1,TMS14F1292P0012,52,UYAB1901CS,23354,7727,3.8,3,14674,5083,-15627,-9591,-0.8
1,TMS14F1295P0012,53,UYAB1901CS,19492,9976,2.4,2,12070,4531,-9516,-7539,-0.4
1,TMS14F1297P0019,54,UYAB1901CS,31117,7873,4.7,5,11469,5177,-23244,-6292,0.3
1,TMS14F1299P0007,55,UYAB1901CS,30497,6009,4.8,4,13059,3583,-24488,-9476,-0.8
1,TMS14F1300P0002,56,UYAB1901CS,30381,6889,4.8,NA,9967,3094,-23492,-6873,NA
1,TMS14F1300P0008,57,UYAB1901CS,28590,7991,5,5,15846,6917,-20599,-8929,0
1,TMS14F1301P0004,58,UYAB1901CS,31172,9474,4.8,NA,10984,6948,-21698,-4036,NA
1,TMS14F1301P0013,59,UYAB1901CS,29743,14202,4.9,10,14069,6448,-15541,-7621,5.1
1,TMS14F1303P0012,60,UYAB1901CS,30427,8397,4.8,10,11141,3510,-22030,-7631,5.2
1,TMS14F1306P0008,61,UYAB1901CS,32332,14532,4.8,8,13221,6823,-17800,-6398,3.2
1,TMS14F1306P0015,62,UYAB1901CS,29771,6328,4.8,4,12926,6375,-23443,-6551,-0.8
1,TMS14F1306P0020,63,UYAB1901CS,24214,10362,3.5,4,8345,6708,-13852,-1637,0.5
1,TMS14F1310P0004,64,UYAB1901CS,29741,6618,5,6,15255,3948,-23123,-11307,1
1,TMS14F1310P0015,65,UYAB1901CS,14720,9970,12.7,NA,18521,3219,-4750,-15302,NA
1,TMS14F1311P0002,66,UYAB1901CS,29568,11859,5,6,15565,4583,-17709,-10982,1
1,TMS14F1312P0003,67,UYAB1901CS,31526,6853,4.7,5,10984,2438,-24673,-8546,0.3
2,IITA-TMS-IBA000070,1,UYAG1701CS,29143,12043,4.9,6,11743,9514,-17100,-2229,1.1
2,IITA-TMS-IBA30572,2,UYAG1701CS,21960,8082,4.9,3,11733,11736,-13878,3,-1.9
2,IITA-TMS-IBA980581,3,UYAG1701CS,25675,8787,4.8,6,10731,10312,-16888,-419,1.2
2,IITA-TMS-IBA982101,4,UYAG1701CS,23906,8181,4,4,10541,12049,-15725,1508,0
2,TMEB419,5,UYAG1701CS,16601,11592,4.9,4,10552,10799,-5009,247,-0.9
2,TMS13F1021P0008,6,UYAG1701CS,26547,11479,4.7,5,10082,10694,-15068,612,0.3
2,TMS13F1114P0001,7,UYAG1701CS,25162,11248,4.9,5,11572,11146,-13914,-426,0.0999999999999996
2,TMS13F1182P0002,8,UYAG1701CS,29830,10331,4.6,6,9054,10972,-19499,1918,1.4
2,TMS13F1461P0002,9,UYAG1701CS,28997,11475,4.8,6,11110,13854,-17522,2744,1.2
2,TMS13F2061P0005,10,UYAG1701CS,23073,7866,4.7,4,11693,10868,-15207,-825,-0.7
2,TMS13F2207P0001,11,UYAG1701CS,29578,12267,4.6,6,9756,11736,-17311,1980,1.4
2,TMS14F1001P0004,12,UYAG1701CS,24656,13704,4.1,4,10677,12500,-10952,1823,-0.0999999999999996
2,TMS14F1016P0006,13,UYAG1701CS,30086,15349,4.7,16,10330,10938,-14737,608,11.3
2,TMS14F1022P0006,14,UYAG1701CS,30508,11593,4.7,10,10371,9896,-18915,-475,5.3
2,TMS14F1035P0004,15,UYAG1701CS,23193,12298,5.1,6,13687,8542,-10895,-5145,0.9
2,TMS14F1035P0007,16,UYAG1701CS,30736,11206,4.6,7,9550,9132,-19530,-418,2.4
2,TMS14F1036P0007,17,UYAG1701CS,29187,13686,4.8,7,10267,11111,-15501,844,2.2
2,TMS14F1049P0001,18,UYAG1701CS,30485,9120,4.6,7,10489,11076,-21365,587,2.4
2,TMS14F1120P0003,19,UYAG1701CS,22451,10382,4.8,5,13110,12188,-12069,-922,0.2
2,TMS14F1131P0001,20,UYAG1701CS,21511,13267,4.8,3,11941,14132,-8244,2191,-1.8
2,TMS14F1194P0002,21,UYAG1701CS,21874,11853,3,NA,7877,11389,-10021,3512,NA
2,TMS14F1195P0005,22,UYAG1701CS,21052,9328,5.1,5,14572,12222,-11724,-2350,-0.0999999999999996
2,TMS14F1208P0007,23,UYAG1701CS,26108,9819,5,7,12920,9896,-16289,-3024,2
2,TMS14F1223P0007,24,UYAG1701CS,22161,11489,4.7,4,11415,7326,-10672,-4089,-0.7
2,TMS14F1224P0004,25,UYAG1701CS,17995,12467,4.9,2,15352,10312,-5528,-5040,-2.9
2,TMS14F1262P0002,26,UYAG1701CS,22915,11750,4.9,5,13569,13438,-11165,-131,0.0999999999999996
2,TMS14F1285P0017,27,UYAG1701CS,24721,12114,4,NA,8394,8090,-12607,-304,NA
2,TMS14F1291P0011,28,UYAG1701CS,24702,9412,3.9,NA,8383,9757,-15290,1374,NA
2,TMS14F1297P0019,29,UYAG1701CS,25102,11493,4.6,5,8405,13889,-13609,5484,0.4
2,TMS14F1300P0008,30,UYAG1701CS,26672,12724,4.8,5,12622,12118,-13948,-504,0.2
2,TMS14F1303P0012,31,UYAG1701CS,29799,13397,4.6,10,9078,14062,-16402,4984,5.4
2,TMS14F1306P0015,32,UYAG1701CS,22392,14854,3.3,4,9805,11458,-7538,1653,0.7
2,TMS14F1306P0020,33,UYAG1701CS,16803,11533,2.9,4,6444,12535,-5270,6091,1.1
2,TMS14F1310P0004,34,UYAG1701CS,28063,12931,4.8,6,12635,10729,-15132,-1906,1.2
2,TMS14F1311P0002,35,UYAG1701CS,27477,8939,4.9,6,12773,11493,-18538,-1280,1.1
2,TMS14F1312P0003,36,UYAG1701CS,25697,8899,4.6,5,8310,13229,-16798,4919,0.4
3,IITA-TMS-IBA000070,1,UYAG1801CS,35333,9363,4.9,6,13987,11875,-25970,-2112,1.1
3,IITA-TMS-IBA30572,2,UYAG1801CS,29893,10875,4.9,3,15566,7361,-19018,-8205,-1.9
3,IITA-TMS-IBA980581,3,UYAG1801CS,38031,10706,4.9,6,14016,10035,-27325,-3981,1.1
3,IITA-TMS-IBA982101,4,UYAG1801CS,31721,7297,4.8,4,12588,8924,-24424,-3664,-0.8
3,TMEB419,5,UYAG1801CS,26869,8675,4.9,4,15122,7812,-18194,-7310,-0.9
3,TMS13F1049P0001,6,UYAG1801CS,23903,9826,3.6,2,13289,8021,-14077,-5268,-1.6
3,TMS13F1126P0003,7,UYAG1801CS,20903,11825,5.2,4,19707,10833,-9078,-8874,-1.2
3,TMS13F1304P0003,8,UYAG1801CS,28743,8654,3.4,3,9289,15347,-20089,6058,-0.4
3,TMS13F1315P0008,9,UYAG1801CS,25840,8824,4.8,2,16335,9201,-17016,-7134,-2.8
3,TMS13F1376P0018,10,UYAG1801CS,31396,8353,3.8,NA,8795,17500,-23043,8705,NA
3,TMS13F1400P0001,11,UYAG1801CS,35488,9093,4.9,4,13869,8507,-26395,-5362,-0.9
3,TMS14F1013P0007,12,UYAG1801CS,32403,8908,4.7,4,10754,9757,-23495,-997,-0.7
3,TMS14F1014P0016,13,UYAG1801CS,28581,9461,4.4,2,12028,9826,-19120,-2202,-2.4
3,TMS14F1014P0017,14,UYAG1801CS,29585,10043,4.8,2,14137,6146,-19542,-7991,-2.8
3,TMS14F1019P0015,15,UYAG1801CS,30090,8386,4.9,3,12407,8819,-21704,-3588,-1.9
3,TMS14F1022P0003,16,UYAG1801CS,19857,11411,2.6,3,12907,10590,-8446,-2317,0.4
3,TMS14F1098P0013,17,UYAG1801CS,34049,11653,5,5,13734,10694,-22396,-3040,0
3,TMS14F1125P0010,18,UYAG1801CS,27260,5822,5,4,15528,11736,-21438,-3792,-1
3,TMS14F1146P0002,19,UYAG1801CS,33614,11944,4.7,NA,9360,10104,-21670,744,NA
3,TMS14F1159P0003,20,UYAG1801CS,29149,8519,4.9,4,12896,9861,-20630,-3035,-0.9
3,TMS14F1195P0004,21,UYAG1801CS,21924,6875,3.7,2,14175,7326,-15049,-6849,-1.7
3,TMS14F1196P0003,22,UYAG1801CS,33927,5622,4.5,2,12177,9340,-28305,-2837,-2.5
3,TMS14F1278P0003,23,UYAG1801CS,19623,11138,4.8,3,17644,11806,-8485,-5838,-1.8
3,TMS14F1285P0006,24,UYAG1801CS,30570,12467,4.3,2,10779,9340,-18103,-1439,-2.3
3,TMS14F1287P0008,25,UYAG1801CS,39241,7879,4.7,8,10556,11562,-31362,1006,3.3
3,TMS14F1288P0008,26,UYAG1801CS,22110,6927,2.1,1,8813,6250,-15183,-2563,-1.1
3,TMS14F1291P0003,27,UYAG1801CS,34077,8065,4.7,NA,9435,11458,-26012,2023,NA
3,TMS14F1291P0012,28,UYAG1801CS,30154,7656,5,8,14694,10312,-22498,-4382,3
3,TMS14F1292P0012,29,UYAG1801CS,22503,9179,3.9,3,14602,8194,-13324,-6408,-0.9
3,TMS14F1295P0012,30,UYAG1801CS,20165,8282,2.5,2,12085,12986,-11883,901,-0.5
3,TMS14F1299P0007,31,UYAG1801CS,38048,12852,4.8,4,12422,10417,-25196,-2005,-0.8
3,TMS14F1300P0002,32,UYAG1801CS,34105,12125,4.7,NA,9400,8958,-21980,-442,NA
3,TMS14F1301P0004,33,UYAG1801CS,36799,9939,4.8,NA,9820,9028,-26860,-792,NA
3,TMS14F1301P0013,34,UYAG1801CS,35755,7282,5,10,13255,10972,-28473,-2283,5
3,TMS14F1306P0008,35,UYAG1801CS,39604,10372,4.8,8,13410,9514,-29232,-3896,3.2
3,TMS14F1310P0015,36,UYAG1801CS,22855,8242,13,NA,18153,13438,-14613,-4715,NA
4,IITA-TMS-IBA000070,1,UYAG1901CS,32965,19619,4.9,6,12944,8760,-13346,-4184,1.1
4,IITA-TMS-IBA30572,2,UYAG1901CS,30132,8813,4.9,3,15831,8854,-21319,-6977,-1.9
4,IITA-TMS-IBA980581,3,UYAG1901CS,34894,12512,4.9,6,13267,14948,-22382,1681,1.1
4,IITA-TMS-IBA982101,4,UYAG1901CS,32421,11663,4.8,4,12703,14062,-20758,1359,-0.8
4,TMEB419,5,UYAG1901CS,25958,15039,4.9,4,15332,15521,-10919,189,-0.9
4,TMS13F1021P0008,6,UYAG1901CS,34933,16682,4.8,5,13433,18021,-18251,4588,0.2
4,TMS13F1114P0001,7,UYAG1901CS,31975,13610,5,5,13894,9719,-18365,-4175,0
4,TMS13F1182P0002,8,UYAG1901CS,36934,17438,4.8,6,10580,14990,-19496,4410,1.2
4,TMS13F1461P0002,9,UYAG1901CS,34174,13776,4.9,6,12470,14438,-20398,1968,1.1
4,TMS13F2061P0005,10,UYAG1901CS,30108,14419,4.9,4,14263,13719,-15689,-544,-0.9
4,TMS13F2207P0001,11,UYAG1901CS,37368,14849,4.8,6,11674,11635,-22519,-39,1.2
4,TMS14F1001P0004,12,UYAG1901CS,32211,17138,4.8,4,12664,12479,-15073,-185,-0.8
4,TMS14F1016P0006,13,UYAG1901CS,36261,13427,4.8,16,12285,11458,-22834,-827,11.2
4,TMS14F1022P0006,14,UYAG1901CS,36497,15874,4.8,10,12441,10031,-20623,-2410,5.2
4,TMS14F1035P0004,15,UYAG1901CS,24859,14998,5.1,6,18671,4875,-9861,-13796,0.9
4,TMS14F1035P0007,16,UYAG1901CS,36420,11024,4.8,7,10888,8781,-25396,-2107,2.2
4,TMS14F1036P0007,17,UYAG1901CS,35178,18794,4.9,7,11967,13479,-16384,1512,2.1
4,TMS14F1049P0001,18,UYAG1901CS,36299,12027,4.8,7,12030,8802,-24272,-3228,2.2
4,TMS14F1120P0003,19,UYAG1901CS,27844,8021,5,5,15899,13802,-19823,-2097,0
4,TMS14F1131P0001,20,UYAG1901CS,30126,14609,5,3,14667,9406,-15517,-5261,-2
4,TMS14F1194P0002,21,UYAG1901CS,31555,15153,4.4,NA,9385,10333,-16402,948,NA
4,TMS14F1195P0005,22,UYAG1901CS,21003,13425,5.2,5,20841,8771,-7578,-12070,-0.2
4,TMS14F1208P0007,23,UYAG1901CS,28380,16267,5.1,7,16228,12646,-12113,-3582,1.9
4,TMS14F1223P0007,24,UYAG1901CS,30847,13773,5,4,14059,6448,-17074,-7611,-1
4,TMS14F1224P0004,25,UYAG1901CS,20302,11968,5.1,2,22114,7167,-8334,-14947,-3.1
4,TMS14F1262P0002,26,UYAG1901CS,26220,14109,4.9,5,16230,10906,-12111,-5324,0.0999999999999996
4,TMS14F1285P0017,27,UYAG1901CS,33230,18921,4.8,NA,9501,7521,-14309,-1980,NA
4,TMS14F1291P0011,28,UYAG1901CS,33032,15991,4.8,NA,10091,8604,-17041,-1487,NA
4,TMS14F1297P0019,29,UYAG1901CS,36640,14444,4.7,5,10731,11781,-22196,1050,0.3
4,TMS14F1300P0008,30,UYAG1901CS,29802,16798,4.9,5,15052,16781,-13004,1729,0.0999999999999996
4,TMS14F1303P0012,31,UYAG1901CS,36503,13654,4.8,10,10478,14771,-22849,4293,5.2
4,TMS14F1306P0015,32,UYAG1901CS,31185,16788,4.8,4,11943,10719,-14397,-1224,-0.8
4,TMS14F1306P0020,33,UYAG1901CS,27209,11279,3.5,4,8385,8292,-15930,-93,0.5
4,TMS14F1310P0004,34,UYAG1901CS,31202,12511,5,6,13975,7854,-18691,-6121,1
4,TMS14F1311P0002,35,UYAG1901CS,30588,15266,5,6,14279,11667,-15322,-2612,1
4,TMS14F1312P0003,36,UYAG1901CS,35612,12932,4.7,5,10120,15990,-22680,5870,0.3
5,IITA-TMS-IBA000070,1,UYIB1701CS,34416,15661,4.8,6,13210,6194,-18755,-7016,1.2
5,IITA-TMS-IBA30572,2,UYIB1701CS,27483,13582,4.9,3,13165,9806,-13901,-3359,-1.9
5,IITA-TMS-IBA980581,3,UYIB1701CS,31284,13842,4.9,6,12060,8542,-17442,-3518,1.1
5,IITA-TMS-IBA982101,4,UYIB1701CS,29800,7992,4.5,4,12474,10153,-21808,-2321,-0.5
5,TMEB419,5,UYIB1701CS,22542,11333,5,4,12526,8542,-11209,-3984,-1
5,TMS13F1021P0008,6,UYIB1701CS,32039,19392,4.8,5,12382,9375,-12647,-3007,0.2
5,TMS13F1114P0001,7,UYIB1701CS,30590,18939,5,5,13077,14028,-11651,951,0
5,TMS13F1182P0002,8,UYIB1701CS,34113,15216,4.6,6,10980,9375,-18897,-1605,1.4
5,TMS13F1461P0002,9,UYIB1701CS,34103,16884,4.8,6,12869,10833,-17219,-2036,1.2
5,TMS13F2061P0005,10,UYIB1701CS,28935,15958,4.8,4,13213,10431,-12977,-2782,-0.8
5,TMS13F2207P0001,11,UYIB1701CS,34162,19782,4.7,6,12021,8778,-14380,-3243,1.3
5,TMS14F1001P0004,12,UYIB1701CS,30732,12904,4.8,4,12690,7778,-17828,-4912,-0.8
5,TMS14F1016P0006,13,UYIB1701CS,35532,12059,4.8,16,12614,5972,-23473,-6642,11.2
5,TMS14F1022P0006,14,UYIB1701CS,35110,12197,4.8,10,12517,5792,-22913,-6725,5.2
5,TMS14F1035P0004,15,UYIB1701CS,27429,17063,5.1,6,15285,5417,-10366,-9868,0.9
5,TMS14F1035P0007,16,UYIB1701CS,35171,16536,4.6,7,11589,5403,-18635,-6186,2.4
5,TMS14F1036P0007,17,UYIB1701CS,34068,18896,4.7,7,12626,11042,-15172,-1584,2.3
5,TMS14F1049P0001,18,UYIB1701CS,35175,14606,4.8,7,12366,7778,-20569,-4588,2.2
5,TMS14F1120P0003,19,UYIB1701CS,29133,6331,5.1,5,14521,8889,-22802,-5632,-0.0999999999999996
5,TMS14F1194P0002,20,UYIB1701CS,28405,11147,2.9,NA,8947,11458,-17258,2511,NA
5,TMS14F1195P0005,21,UYIB1701CS,24799,15680,5.2,5,16447,9819,-9119,-6628,-0.2
5,TMS14F1223P0007,22,UYIB1701CS,29143,16931,4.4,4,13224,3778,-12212,-9446,-0.4
5,TMS14F1262P0002,23,UYIB1701CS,28900,11345,4.9,5,15145,9792,-17555,-5353,0.0999999999999996
5,TMS14F1285P0017,24,UYIB1701CS,31867,12776,3.8,NA,9863,5014,-19091,-4849,NA
5,TMS14F1291P0011,25,UYIB1701CS,31681,13975,3.8,NA,9830,4375,-17706,-5455,NA
5,TMS14F1297P0019,26,UYIB1701CS,29986,5417,4.5,5,10484,5875,-24569,-4609,0.5
5,TMS14F1300P0008,27,UYIB1701CS,31799,16404,4.8,5,13904,12083,-15395,-1821,0.2
5,TMS14F1303P0012,28,UYIB1701CS,34258,14280,4.6,10,10981,8875,-19978,-2106,5.4
5,TMS14F1306P0015,29,UYIB1701CS,28699,12645,3.4,4,11236,8306,-16054,-2930,0.6
5,TMS14F1306P0020,30,UYIB1701CS,20160,17831,2.7,4,7389,8556,-2329,1167,1.3
5,TMS14F1310P0004,31,UYIB1701CS,33038,11087,5,6,13729,4514,-21951,-9215,1
5,TMS14F1311P0002,32,UYIB1701CS,32519,11535,5,6,13976,8819,-20984,-5157,1
5,TMS14F1312P0003,33,UYIB1701CS,30978,17394,4.5,5,10054,7958,-13584,-2096,0.5
6,IITA-TMS-IBA000070,1,UYIB1801CS,39148,19598,5.2,6,13627,6726,-19550,-6901,0.8
6,IITA-TMS-IBA30572,2,UYIB1801CS,33104,13945,4.9,3,14035,9823,-19159,-4212,-1.9
6,IITA-TMS-IBA980581,3,UYIB1801CS,35941,13473,4.9,6,12558,8441,-22468,-4117,1.1
6,IITA-TMS-IBA982101,4,UYIB1801CS,35123,12288,4.4,4,12852,9094,-22835,-3758,-0.4
6,TMEB419,5,UYIB1801CS,27103,9208,5.1,4,13226,7983,-17895,-5243,-1.1
6,TMS13F1021P0008,6,UYIB1801CS,36127,20129,4.8,5,12875,7826,-15998,-5049,0.2
6,TMS13F1049P0001,7,UYIB1801CS,25549,13441,2.6,2,11582,6681,-12108,-4901,-0.6
6,TMS13F1114P0001,8,UYIB1801CS,34529,15432,5.1,5,13531,8326,-19097,-5205,-0.0999999999999996
6,TMS13F1182P0002,9,UYIB1801CS,39675,14316,4.8,6,11445,9674,-25359,-1771,1.2
6,TMS13F1304P0003,10,UYIB1801CS,25172,19750,3.2,3,8500,6167,-5422,-2333,-0.2
6,TMS13F1315P0008,11,UYIB1801CS,29572,15883,4.7,2,14211,9514,-13689,-4697,-2.7
6,TMS13F1376P0018,12,UYIB1801CS,31887,19474,2.7,NA,9363,4625,-12413,-4738,NA
6,TMS13F1400P0001,13,UYIB1801CS,38829,10535,5.2,4,13559,8514,-28294,-5045,-1.2
6,TMS13F1461P0002,14,UYIB1801CS,39028,9234,5.1,6,13384,5264,-29794,-8120,0.9
6,TMS13F2061P0005,15,UYIB1801CS,34681,12111,4.8,4,13778,8090,-22570,-5688,-0.8
6,TMS13F2207P0001,16,UYIB1801CS,39732,20434,4.8,6,12585,9271,-19298,-3314,1.2
6,TMS14F1001P0004,17,UYIB1801CS,35256,19194,4.7,4,12968,8361,-16062,-4607,-0.7
6,TMS14F1013P0007,18,UYIB1801CS,30298,13330,3.6,4,10190,6590,-16968,-3600,0.4
6,TMS14F1016P0006,19,UYIB1801CS,40365,24604,4.8,16,13083,8194,-15761,-4889,11.2
6,TMS14F1019P0015,20,UYIB1801CS,32897,18476,3.9,3,11840,7507,-14421,-4333,-0.9
6,TMS14F1022P0003,21,UYIB1801CS,19481,17503,2,3,11101,5660,-1978,-5441,1
6,TMS14F1022P0006,22,UYIB1801CS,40505,22827,4.8,10,12910,7590,-17678,-5320,5.2
6,TMS14F1035P0004,23,UYIB1801CS,32104,20330,5.2,6,15635,5917,-11774,-9718,0.8
6,TMS14F1035P0007,24,UYIB1801CS,40274,20441,4.8,7,11911,6868,-19833,-5043,2.2
6,TMS14F1036P0007,25,UYIB1801CS,38999,22640,5.1,7,13140,11278,-16359,-1862,1.9
6,TMS14F1049P0001,26,UYIB1801CS,40530,14082,4.8,7,12935,7576,-26448,-5359,2.2
6,TMS14F1120P0003,27,UYIB1801CS,32878,12946,5,5,14904,7007,-19932,-7897,0
6,TMS14F1125P0010,28,UYIB1801CS,32844,17841,4.9,4,14452,7368,-15003,-7084,-0.9
6,TMS14F1146P0002,29,UYIB1801CS,34560,16711,3.4,NA,10072,6208,-17849,-3864,NA
6,TMS14F1159P0003,30,UYIB1801CS,31679,11622,4.7,4,12056,6312,-20057,-5744,-0.7
6,TMS14F1194P0002,31,UYIB1801CS,32412,10323,3.2,NA,9624,7611,-22089,-2013,NA
6,TMS14F1195P0004,32,UYIB1801CS,22508,10860,2.8,2,12141,7188,-11648,-4953,-0.8
6,TMS14F1195P0005,33,UYIB1801CS,29535,16551,5.2,5,16842,6819,-12984,-10023,-0.2
6,TMS14F1223P0007,34,UYIB1801CS,32876,18802,4.8,4,13194,4861,-14074,-8333,-0.8
6,TMS14F1262P0002,35,UYIB1801CS,32479,18393,5,5,15581,7785,-14086,-7796,0
6,TMS14F1278P0003,36,UYIB1801CS,22352,14786,3.2,3,14847,5507,-7566,-9340,-0.2
6,TMS14F1285P0017,37,UYIB1801CS,36174,17392,3.9,NA,10347,4604,-18782,-5743,NA
6,TMS14F1287P0008,38,UYIB1801CS,38250,17799,4.8,8,10781,9417,-20451,-1364,3.2
6,TMS14F1288P0008,39,UYIB1801CS,20061,13304,2,1,7886,9865,-6757,1979,-1
6,TMS14F1291P0003,40,UYIB1801CS,35538,18923,3.6,NA,10250,5806,-16615,-4444,NA
6,TMS14F1291P0011,41,UYIB1801CS,35930,5791,3.9,NA,10551,2698,-30139,-7853,NA
6,TMS14F1291P0012,42,UYIB1801CS,36189,14898,5.1,8,14140,5458,-21291,-8682,2.9
6,TMS14F1295P0012,43,UYIB1801CS,19793,16071,1.7,2,10477,7792,-3722,-2685,0.3
6,TMS14F1297P0019,44,UYIB1801CS,34323,9452,4.4,5,10874,7618,-24871,-3256,0.6
6,TMS14F1299P0007,45,UYIB1801CS,40212,13983,5.1,4,13112,9160,-26229,-3952,-1.1
6,TMS14F1300P0002,46,UYIB1801CS,35563,15890,3.6,NA,10238,8219,-19673,-2019,NA
6,TMS14F1300P0008,47,UYIB1801CS,36380,15678,4.9,5,14343,9097,-20702,-5246,0.0999999999999996
6,TMS14F1301P0004,48,UYIB1801CS,39031,17950,4.6,NA,11399,8944,-21081,-2455,NA
6,TMS14F1301P0013,49,UYIB1801CS,38730,16455,5.1,10,13564,7646,-22275,-5918,4.9
6,TMS14F1303P0012,50,UYIB1801CS,39564,16499,4.8,10,11373,9042,-23065,-2331,5.2
6,TMS14F1306P0008,51,UYIB1801CS,40351,14478,4.8,8,12880,8427,-25873,-4453,3.2
6,TMS14F1306P0015,52,UYIB1801CS,33854,19343,3.6,4,11813,8875,-14511,-2938,0.4
6,TMS14F1306P0020,53,UYIB1801CS,22296,16770,3.2,4,7747,8583,-5526,836,0.8
6,TMS14F1310P0004,54,UYIB1801CS,37152,15842,5,6,14244,5514,-21310,-8730,1
6,TMS14F1310P0015,55,UYIB1801CS,26056,19443,12.8,NA,18758,7521,-6613,-11237,NA
6,TMS14F1311P0002,56,UYIB1801CS,36504,18289,5.2,6,14319,9243,-18215,-5076,0.8
6,TMS14F1312P0003,57,UYIB1801CS,34749,17622,4.4,5,10354,7229,-17127,-3125,0.6
7,IITA-TMS-IBA000070,1,UYIB1901CS,26075,10594,4.9,6,10659,6203,-15481,-4456,1.1
7,IITA-TMS-IBA30572,2,UYIB1901CS,24397,5542,4.9,3,12577,6526,-18855,-6051,-1.9
7,IITA-TMS-IBA980581,3,UYIB1901CS,27318,9403,4.9,6,10558,10750,-17915,192,1.1
7,IITA-TMS-IBA982101,4,UYIB1901CS,25655,6354,4.8,4,10591,9750,-19301,-841,-0.8
7,TMEB419,5,UYIB1901CS,19948,8395,4.3,4,12327,8286,-11553,-4041,-0.3
7,TMS13F1021P0008,6,UYIB1901CS,27926,6990,4.8,5,10361,7542,-20936,-2819,0.2
7,TMS13F1049P0001,7,UYIB1901CS,19255,4127,3.1,2,11366,4000,-15128,-7366,-1.1
7,TMS13F1114P0001,8,UYIB1901CS,25711,9634,4.9,5,11156,6479,-16077,-4677,0.0999999999999996
7,TMS13F1126P0003,9,UYIB1901CS,18675,5852,5.1,4,15709,3708,-12823,-12001,-1.1
7,TMS13F1182P0002,10,UYIB1901CS,29059,8842,4.7,6,8549,6604,-20217,-1945,1.3
7,TMS13F1304P0003,11,UYIB1901CS,22071,9367,3.4,3,7883,9042,-12704,1159,-0.4
7,TMS13F1315P0008,12,UYIB1901CS,21444,9611,4.8,2,13726,14010,-11833,284,-2.8
7,TMS13F1376P0018,13,UYIB1901CS,24838,9116,3.8,NA,7473,4167,-15722,-3306,NA
7,TMS13F1400P0001,14,UYIB1901CS,26092,6642,4.9,4,10511,8750,-19450,-1761,-0.9
7,TMS13F1461P0002,15,UYIB1901CS,26985,7763,4.9,6,10290,7594,-19222,-2696,1.1
7,TMS13F2061P0005,16,UYIB1901CS,24998,7934,4.9,4,11895,7500,-17064,-4395,-0.9
7,TMS13F2207P0001,17,UYIB1901CS,28772,8186,4.8,6,9306,9625,-20586,319,1.2
7,TMS14F1001P0004,18,UYIB1901CS,26672,9135,4.8,4,10722,7063,-17537,-3659,-0.8
7,TMS14F1013P0007,19,UYIB1901CS,25783,6900,4.5,4,9157,5583,-18883,-3574,-0.5
7,TMS14F1014P0016,20,UYIB1901CS,23024,11528,4,2,10245,9375,-11496,-870,-2
7,TMS14F1014P0017,21,UYIB1901CS,24553,9123,4.7,2,12161,8375,-15430,-3786,-2.7
7,TMS14F1016P0006,22,UYIB1901CS,27635,8075,4.8,16,9519,6833,-19560,-2686,11.2
7,TMS14F1019P0015,23,UYIB1901CS,25167,5059,4.8,3,10394,4865,-20108,-5529,-1.8
7,TMS14F1022P0003,24,UYIB1901CS,15639,11799,2.3,3,10941,8062,-3840,-2879,0.7
7,TMS14F1022P0006,25,UYIB1901CS,28061,8631,4.8,10,9426,5094,-19430,-4332,5.2
7,TMS14F1035P0004,26,UYIB1901CS,19544,11789,5.1,6,14980,5958,-7755,-9022,0.9
7,TMS14F1035P0007,27,UYIB1901CS,28851,8289,4.8,7,8720,4719,-20562,-4001,2.2
7,TMS14F1036P0007,28,UYIB1901CS,27258,11750,4.9,7,9606,8438,-15508,-1168,2.1
7,TMS14F1049P0001,29,UYIB1901CS,28218,5750,4.8,7,9740,6948,-22468,-2792,2.2
7,TMS14F1098P0013,30,UYIB1901CS,26066,13556,4.9,5,10905,6625,-12510,-4280,0.0999999999999996
7,TMS14F1120P0003,31,UYIB1901CS,22096,6533,5,5,13029,8865,-15563,-4164,0
7,TMS14F1125P0010,32,UYIB1901CS,23380,10161,4.9,4,12755,5875,-13219,-6880,-0.9
7,TMS14F1131P0001,33,UYIB1901CS,24542,8463,5,3,12334,5021,-16079,-7313,-2
7,TMS14F1146P0002,34,UYIB1901CS,26741,6071,4.7,NA,7844,3625,-20670,-4219,NA
7,TMS14F1159P0003,35,UYIB1901CS,24465,12483,4.9,4,10850,9979,-11982,-871,-0.9
7,TMS14F1194P0002,36,UYIB1901CS,25893,8727,4.3,NA,7783,9031,-17166,1248,NA
7,TMS14F1195P0004,37,UYIB1901CS,17531,9446,3.4,2,12079,8771,-8085,-3308,-1.4
7,TMS14F1195P0005,38,UYIB1901CS,16086,8413,5.2,5,17564,7552,-7673,-10012,-0.2
7,TMS14F1196P0003,39,UYIB1901CS,26820,10014,4.3,2,9584,4562,-16806,-5022,-2.3
7,TMS14F1208P0007,40,UYIB1901CS,22768,9311,5,7,12752,7854,-13457,-4898,2
7,TMS14F1223P0007,41,UYIB1901CS,24143,10530,4.9,4,11670,5396,-13613,-6274,-0.9
7,TMS14F1262P0002,42,UYIB1901CS,21422,12587,4.9,5,13676,8250,-8835,-5426,0.0999999999999996
7,TMS14F1278P0003,43,UYIB1901CS,16372,8371,4.2,3,15211,5510,-8001,-9701,-1.2
7,TMS14F1285P0006,44,UYIB1901CS,24562,10397,4.1,2,9112,6125,-14165,-2987,-2.1
7,TMS14F1285P0017,45,UYIB1901CS,27423,7439,4.8,NA,8022,5844,-19984,-2178,NA
7,TMS14F1287P0008,46,UYIB1901CS,29322,13343,4.7,8,8332,9260,-15979,928,3.3
7,TMS14F1288P0008,47,UYIB1901CS,17595,4668,2.1,1,7592,8812,-12927,1220,-1.1
7,TMS14F1291P0003,48,UYIB1901CS,27028,3729,4.7,NA,7911,3792,-23299,-4119,NA
7,TMS14F1291P0011,49,UYIB1901CS,27413,7678,4.8,NA,8020,5719,-19735,-2301,NA
7,TMS14F1291P0012,50,UYIB1901CS,24024,7871,4.9,8,11732,7688,-16153,-4044,3.1
7,TMS14F1292P0012,51,UYIB1901CS,18207,7440,3.5,3,12487,3979,-10767,-8508,-0.5
7,TMS14F1295P0012,52,UYIB1901CS,15406,11089,2.1,2,10262,8115,-4317,-2147,-0.1
7,TMS14F1297P0019,53,UYIB1901CS,28809,3812,4.7,5,8550,8562,-24997,12,0.3
7,TMS14F1299P0007,54,UYIB1901CS,27748,10045,4.8,4,9489,6573,-17703,-2916,-0.8
7,TMS14F1300P0002,55,UYIB1901CS,27056,8047,4.8,NA,7918,6719,-19009,-1199,NA
7,TMS14F1300P0008,56,UYIB1901CS,23812,11321,4.9,5,11833,11125,-12491,-708,0.0999999999999996
7,TMS14F1301P0004,57,UYIB1901CS,28194,10298,4.8,NA,8061,7104,-17896,-957,NA
7,TMS14F1301P0013,58,UYIB1901CS,26179,10223,4.9,10,10216,7448,-15956,-2768,5.1
7,TMS14F1303P0012,59,UYIB1901CS,28962,9121,4.7,10,8562,7979,-19841,-583,5.3
7,TMS14F1306P0008,60,UYIB1901CS,28292,5865,4.8,8,9793,7094,-22427,-2699,3.2
7,TMS14F1306P0015,61,UYIB1901CS,25802,8488,4.7,4,10186,8083,-17314,-2103,-0.7
7,TMS14F1306P0020,62,UYIB1901CS,22108,8737,3.5,4,7329,8146,-13371,817,0.5
7,TMS14F1310P0004,63,UYIB1901CS,24089,6646,4.9,6,11174,4219,-17443,-6955,1.1
7,TMS14F1310P0015,64,UYIB1901CS,28058,8580,4.8,NA,8025,5844,-19478,-2181,NA
7,TMS14F1311P0002,65,UYIB1901CS,23606,8632,5,6,11519,6812,-14974,-4707,1
7,TMS14F1312P0003,66,UYIB1901CS,28276,8801,4.7,5,8426,5292,-19475,-3134,0.3
8,IITA-TMS-IBA000070,1,UYIK1701CS,39973,13302,4.7,6,14020,7812,-26671,-6208,1.3
8,IITA-TMS-IBA30572,2,UYIK1701CS,30648,9645,4.9,3,13726,8681,-21003,-5045,-1.9
8,IITA-TMS-IBA980581,3,UYIK1701CS,36494,9302,4.9,6,12672,6111,-27192,-6561,1.1
8,IITA-TMS-IBA982101,4,UYIK1701CS,32797,9319,4.3,4,12743,8125,-23478,-4618,-0.3
8,TMEB419,5,UYIK1701CS,23727,9350,5,4,12593,7292,-14377,-5301,-1
8,TMS13F1021P0008,6,UYIK1701CS,35539,12969,4.8,5,12860,9549,-22570,-3311,0.2
8,TMS13F1049P0001,7,UYIK1701CS,21502,NA,2.6,2,11357,NA,NA,NA,-0.6
8,TMS13F1114P0001,8,UYIK1701CS,35072,7656,4.8,5,13823,7812,-27416,-6011,0.2
8,TMS13F1126P0003,9,UYIK1701CS,27360,NA,4.8,4,16186,NA,NA,NA,-0.8
8,TMS13F1182P0002,10,UYIK1701CS,37003,9623,4.7,6,10943,8333,-27380,-2610,1.3
8,TMS13F1304P0003,11,UYIK1701CS,22370,NA,3.1,3,8265,NA,NA,NA,-0.1
8,TMS13F1315P0008,12,UYIK1701CS,27269,NA,4.7,2,14146,NA,NA,NA,-2.7
8,TMS13F1376P0018,13,UYIK1701CS,28907,NA,3,NA,9048,NA,NA,NA,NA
8,TMS13F1400P0001,14,UYIK1701CS,39527,NA,4.8,4,13870,NA,NA,NA,-0.8
8,TMS13F1461P0002,15,UYIK1701CS,39037,12589,4.7,6,13570,10069,-26448,-3501,1.3
8,TMS13F2061P0005,16,UYIK1701CS,32055,12142,4.7,4,13736,7812,-19913,-5924,-0.7
8,TMS13F2207P0001,17,UYIK1701CS,38513,12067,4.7,6,12574,9514,-26446,-3060,1.3
8,TMS14F1001P0004,18,UYIK1701CS,34303,13023,4.4,4,12840,7465,-21280,-5375,-0.4
8,TMS14F1013P0007,19,UYIK1701CS,28122,NA,3.7,4,9898,NA,NA,NA,0.3
8,TMS14F1014P0016,20,UYIK1701CS,26257,NA,3.5,2,11276,NA,NA,NA,-1.5
8,TMS14F1014P0017,21,UYIK1701CS,29108,NA,4.8,2,13574,NA,NA,NA,-2.8
8,TMS14F1016P0006,22,UYIK1701CS,38765,13842,4.8,16,13020,6458,-24923,-6562,11.2
8,TMS14F1019P0015,23,UYIK1701CS,29975,NA,4.3,3,11906,NA,NA,NA,-1.3
8,TMS14F1022P0003,24,UYIK1701CS,17105,NA,2.1,3,10794,NA,NA,NA,0.9
8,TMS14F1022P0006,25,UYIK1701CS,38883,13724,4.8,10,12984,7188,-25159,-5796,5.2
8,TMS14F1035P0004,26,UYIK1701CS,32106,14428,5,6,16302,5347,-17678,-10955,1
8,TMS14F1035P0007,27,UYIK1701CS,38321,8689,4.7,7,11476,5799,-29632,-5677,2.3
8,TMS14F1036P0007,28,UYIK1701CS,38282,14861,4.7,7,12970,9132,-23421,-3838,2.3
8,TMS14F1049P0001,29,UYIK1701CS,39916,8405,4.7,7,13036,5590,-31511,-7446,2.3
8,TMS14F1098P0013,30,UYIK1701CS,38027,NA,4.8,5,13838,NA,NA,NA,0.2
8,TMS14F1120P0003,31,UYIK1701CS,31291,5505,4.9,5,15269,9375,-25786,-5894,0.0999999999999996
8,TMS14F1125P0010,32,UYIK1701CS,31173,NA,4.8,4,14626,NA,NA,NA,-0.8
8,TMS14F1131P0001,33,UYIK1701CS,31193,10301,4.8,3,14110,3819,-20892,-10291,-1.8
8,TMS14F1146P0002,34,UYIK1701CS,32020,NA,3.7,NA,9682,NA,NA,NA,NA
8,TMS14F1159P0003,35,UYIK1701CS,29253,NA,4.8,4,12174,NA,NA,NA,-0.8
8,TMS14F1194P0002,36,UYIK1701CS,29933,13380,3.5,NA,9190,7604,-16553,-1586,NA
8,TMS14F1195P0004,37,UYIK1701CS,19311,NA,2.9,2,12014,NA,NA,NA,-0.9
8,TMS14F1195P0005,38,UYIK1701CS,29137,12712,5,5,17536,9028,-16425,-8508,0
8,TMS14F1196P0003,39,UYIK1701CS,29001,NA,4.2,2,11526,NA,NA,NA,-2.2
8,TMS14F1208P0007,40,UYIK1701CS,36644,10433,5,7,15284,3993,-26211,-11291,2
8,TMS14F1223P0007,41,UYIK1701CS,30827,12435,4.8,4,13251,4965,-18392,-8286,-0.8
8,TMS14F1224P0004,42,UYIK1701CS,27041,15638,4.8,2,18449,7222,-11403,-11227,-2.8
8,TMS14F1262P0002,43,UYIK1701CS,32351,13382,4.8,5,15856,7917,-18969,-7939,0.2
8,TMS14F1278P0003,44,UYIK1701CS,19791,NA,3,3,14501,NA,NA,NA,0
8,TMS14F1285P0006,45,UYIK1701CS,27010,NA,3.3,2,9967,NA,NA,NA,-1.3
8,TMS14F1285P0017,46,UYIK1701CS,33705,10938,4.3,NA,10064,4931,-22767,-5133,NA
8,TMS14F1287P0008,47,UYIK1701CS,36158,NA,4.7,8,10416,NA,NA,NA,3.3
8,TMS14F1288P0008,48,UYIK1701CS,18707,NA,2,1,7819,NA,NA,NA,-1
8,TMS14F1291P0003,49,UYIK1701CS,32789,NA,4,NA,9865,NA,NA,NA,NA
8,TMS14F1291P0011,50,UYIK1701CS,33635,12982,4.2,NA,10093,4271,-20653,-5822,NA
8,TMS14F1291P0012,51,UYIK1701CS,37007,NA,4.8,8,14638,NA,NA,NA,3.2
8,TMS14F1292P0012,52,UYIK1701CS,20606,NA,3,3,12399,NA,NA,NA,0
8,TMS14F1295P0012,53,UYIK1701CS,16766,NA,1.7,2,10248,NA,NA,NA,0.3
8,TMS14F1297P0019,54,UYIK1701CS,32927,9642,4.7,5,10649,7396,-23285,-3253,0.3
8,TMS14F1299P0007,55,UYIK1701CS,39334,NA,4.7,4,12615,NA,NA,NA,-0.7
8,TMS14F1300P0002,56,UYIK1701CS,32718,NA,4,NA,9862,NA,NA,NA,NA
8,TMS14F1300P0008,57,UYIK1701CS,36743,10278,4.7,5,14868,10069,-26465,-4799,0.3
8,TMS14F1301P0004,58,UYIK1701CS,37238,NA,4.7,NA,11078,NA,NA,NA,NA
8,TMS14F1301P0013,59,UYIK1701CS,38994,NA,4.7,10,13768,NA,NA,NA,5.3
8,TMS14F1303P0012,60,UYIK1701CS,36894,12290,4.7,10,10853,11215,-24604,362,5.3
8,TMS14F1306P0008,61,UYIK1701CS,39960,NA,4.7,8,13058,NA,NA,NA,3.3
8,TMS14F1306P0015,62,UYIK1701CS,30725,12603,3.7,4,11412,7917,-18122,-3495,0.3
8,TMS14F1306P0020,63,UYIK1701CS,21765,12339,3.2,4,7654,8194,-9426,540,0.8
8,TMS14F1310P0004,64,UYIK1701CS,38373,13128,4.8,6,14686,6424,-25245,-8262,1.2
8,TMS14F1310P0015,65,UYIK1701CS,26234,NA,12.4,NA,18855,NA,NA,NA,NA
8,TMS14F1311P0002,66,UYIK1701CS,38031,7488,4.8,6,14931,8924,-30543,-6007,1.2
8,TMS14F1312P0003,67,UYIK1701CS,33042,10306,4.7,5,10191,9097,-22736,-1094,0.3
9,IITA-TMS-IBA000070,1,UYIK1801CS,48702,8592,4.8,6,13533,7049,-40110,-6484,1.2
9,IITA-TMS-IBA30572,2,UYIK1801CS,41987,5876,4.1,3,14275,6476,-36111,-7799,-1.1
9,IITA-TMS-IBA980581,3,UYIK1801CS,50285,7869,4.7,6,13505,8021,-42416,-5484,1.3
9,IITA-TMS-IBA982101,4,UYIK1801CS,42606,5607,4.7,4,11832,7396,-36999,-4436,-0.7
9,TMEB419,5,UYIK1801CS,34473,5861,4.9,4,13977,6684,-28612,-7293,-0.9
9,TMS13F1021P0008,6,UYIK1801CS,48907,7925,4.7,5,13525,6042,-40982,-7483,0.3
9,TMS13F1049P0001,7,UYIK1801CS,28569,4006,2.7,2,11278,6250,-24563,-5028,-0.7
9,TMS13F1114P0001,8,UYIK1801CS,47272,4400,4.8,5,13405,5660,-42872,-7745,0.2
9,TMS13F1126P0003,9,UYIK1801CS,34762,3739,4.9,4,16202,6250,-31023,-9952,-0.9
9,TMS13F1182P0002,10,UYIK1801CS,47477,5688,4.7,6,10706,8646,-41789,-2060,1.3
9,TMS13F1304P0003,11,UYIK1801CS,29698,3453,2.9,3,8075,6875,-26245,-1200,0.1
9,TMS13F1315P0008,12,UYIK1801CS,35099,3427,3.9,2,13871,4931,-31672,-8940,-1.9
9,TMS13F1376P0018,13,UYIK1801CS,35570,2781,3.1,NA,8480,9618,-32789,1138,NA
9,TMS13F1400P0001,14,UYIK1801CS,48908,5135,4.8,4,13315,3507,-43773,-9808,-0.8
9,TMS13F1461P0002,15,UYIK1801CS,49708,4215,4.8,6,13065,6771,-45493,-6294,1.2
9,TMS13F2061P0005,16,UYIK1801CS,41219,3889,4.6,4,12910,5000,-37330,-7910,-0.6
9,TMS13F2207P0001,17,UYIK1801CS,50532,7814,4.7,6,12133,6319,-42718,-5814,1.3
9,TMS14F1001P0004,18,UYIK1801CS,43936,7219,4.7,4,11939,6528,-36717,-5411,-0.7
9,TMS14F1013P0007,19,UYIK1801CS,36749,4941,3.8,4,9669,7639,-31808,-2030,0.2
9,TMS14F1014P0016,20,UYIK1801CS,34803,4983,3.4,2,10825,3819,-29820,-7006,-1.4
9,TMS14F1014P0017,21,UYIK1801CS,40400,4033,4,2,13063,5625,-36367,-7438,-2
9,TMS14F1016P0006,22,UYIK1801CS,50260,4297,4.8,16,12805,3472,-45963,-9333,11.2
9,TMS14F1019P0015,23,UYIK1801CS,38455,4109,4.4,3,11191,5451,-34346,-5740,-1.4
9,TMS14F1022P0003,24,UYIK1801CS,21585,3595,1.9,3,10732,6806,-17990,-3926,1.1
9,TMS14F1022P0006,25,UYIK1801CS,50826,4419,4.8,10,12897,3125,-46407,-9772,5.2
9,TMS14F1035P0004,26,UYIK1801CS,39374,6623,5,6,17140,3299,-32751,-13841,1
9,TMS14F1035P0007,27,UYIK1801CS,47938,5908,4.7,7,11027,4618,-42030,-6409,2.3
9,TMS14F1036P0007,28,UYIK1801CS,48371,8551,4.8,7,12146,6250,-39820,-5896,2.2
9,TMS14F1049P0001,29,UYIK1801CS,50804,4961,4.8,7,12744,5625,-45843,-7119,2.2
9,TMS14F1098P0013,30,UYIK1801CS,47778,6283,4.8,5,13176,7222,-41495,-5954,0.2
9,TMS14F1120P0003,31,UYIK1801CS,41442,4409,4.9,5,14475,6840,-37033,-7635,0.0999999999999996
9,TMS14F1125P0010,32,UYIK1801CS,40862,4073,4.9,4,13894,7847,-36789,-6047,-0.9
9,TMS14F1131P0001,33,UYIK1801CS,41327,7333,4.9,3,13349,3542,-33994,-9807,-1.9
9,TMS14F1146P0002,34,UYIK1801CS,39187,3753,3.9,NA,9329,5069,-35434,-4260,NA
9,TMS14F1159P0003,35,UYIK1801CS,38169,3970,4.8,4,11643,5660,-34199,-5983,-0.8
9,TMS14F1194P0002,36,UYIK1801CS,36640,6165,3.6,NA,9038,4722,-30475,-4316,NA
9,TMS14F1195P0004,37,UYIK1801CS,25870,3264,2.8,2,11902,5625,-22606,-6277,-0.8
9,TMS14F1195P0005,38,UYIK1801CS,33989,7439,5.1,5,18918,4965,-26550,-13953,-0.0999999999999996
9,TMS14F1196P0003,39,UYIK1801CS,41917,2812,3.6,2,11190,6181,-39105,-5009,-1.6
9,TMS14F1208P0007,40,UYIK1801CS,44057,5716,4.9,7,15894,4965,-38341,-10929,2.1
9,TMS14F1223P0007,41,UYIK1801CS,39926,6286,4.8,4,12577,3819,-33640,-8758,-0.8
9,TMS14F1224P0004,42,UYIK1801CS,31446,4560,5,2,18884,3993,-26886,-14891,-3
9,TMS14F1262P0002,43,UYIK1801CS,40296,8247,4.8,5,15056,4792,-32049,-10264,0.2
9,TMS14F1278P0003,44,UYIK1801CS,25482,2486,3.6,3,14722,5764,-22996,-8958,-0.6
9,TMS14F1285P0006,45,UYIK1801CS,34962,4757,3.4,2,9646,6215,-30205,-3431,-1.4
9,TMS14F1285P0017,46,UYIK1801CS,41231,8594,4.5,NA,9507,4722,-32637,-4785,NA
9,TMS14F1287P0008,47,UYIK1801CS,46341,6694,4.7,8,10184,7812,-39647,-2372,3.3
9,TMS14F1288P0008,48,UYIK1801CS,22129,2688,1.8,1,7449,3750,-19441,-3699,-0.8
9,TMS14F1291P0003,49,UYIK1801CS,40105,3090,4.2,NA,9513,6389,-37015,-3124,NA
9,TMS14F1291P0011,50,UYIK1801CS,41102,5147,4.5,NA,10244,3229,-35955,-7015,NA
9,TMS14F1291P0012,51,UYIK1801CS,45446,4538,4.9,8,14047,7743,-40908,-6304,3.1
9,TMS14F1292P0012,52,UYIK1801CS,27319,6875,3,3,12265,8750,-20444,-3515,0
9,TMS14F1295P0012,53,UYIK1801CS,22063,4193,1.9,2,10111,5868,-17870,-4243,0.1
9,TMS14F1297P0019,54,UYIK1801CS,45496,5438,4.6,5,10413,7361,-40058,-3052,0.4
9,TMS14F1299P0007,55,UYIK1801CS,49455,5260,4.7,4,11995,8576,-44195,-3419,-0.7
9,TMS14F1300P0002,56,UYIK1801CS,40137,5172,4.2,NA,9425,4896,-34965,-4529,NA
9,TMS14F1300P0008,57,UYIK1801CS,45086,5875,4.9,5,14217,6562,-39211,-7655,0.0999999999999996
9,TMS14F1301P0004,58,UYIK1801CS,45682,6632,4.7,NA,10540,8160,-39050,-2380,NA
9,TMS14F1301P0013,59,UYIK1801CS,48180,5536,4.8,10,12729,7257,-42644,-5472,5.2
9,TMS14F1303P0012,60,UYIK1801CS,47011,6265,4.7,10,10638,6493,-40746,-4145,5.3
9,TMS14F1306P0008,61,UYIK1801CS,50677,5444,4.8,8,12604,6458,-45233,-6146,3.2
9,TMS14F1306P0015,62,UYIK1801CS,38932,8993,4,4,10986,7812,-29939,-3174,0
9,TMS14F1306P0020,63,UYIK1801CS,29053,7687,2.9,4,7593,6736,-21366,-857,1.1
9,TMS14F1310P0004,64,UYIK1801CS,46637,4867,4.9,6,13886,4722,-41770,-9164,1.1
9,TMS14F1310P0015,65,UYIK1801CS,18731,4184,14,NA,14868,7153,-14547,-7715,NA
9,TMS14F1311P0002,66,UYIK1801CS,45948,6698,4.9,6,14280,5833,-39250,-8447,1.1
9,TMS14F1312P0003,67,UYIK1801CS,43449,6541,4.7,5,9875,6181,-36908,-3694,0.3
10,IITA-TMS-IBA000070,1,UYIK1901CS,39332,17732,4.9,6,13710,14635,-21600,925,1.1
10,IITA-TMS-IBA30572,2,UYIK1901CS,34912,9587,4.7,3,15612,16328,-25325,716,-1.7
10,IITA-TMS-IBA980581,3,UYIK1901CS,41523,13494,4.9,6,14098,16901,-28029,2803,1.1
10,IITA-TMS-IBA982101,4,UYIK1901CS,36323,12538,4.8,4,12446,19125,-23785,6679,-0.8
10,TMEB419,5,UYIK1901CS,28735,14040,5,4,15044,15729,-14695,685,-1
10,TMS13F1021P0008,6,UYIK1901CS,40800,10998,4.8,5,13745,12667,-29802,-1078,0.2
10,TMS13F1049P0001,7,UYIK1901CS,25840,10896,3,2,12688,15240,-14944,2552,-1
10,TMS13F1114P0001,8,UYIK1901CS,37446,9189,4.9,5,13980,14135,-28257,155,0.0999999999999996
10,TMS13F1126P0003,9,UYIK1901CS,29012,14529,5,4,18019,15260,-14483,-2759,-1
10,TMS13F1182P0002,10,UYIK1901CS,41690,9945,4.7,6,11112,22875,-31745,11763,1.3
10,TMS13F1304P0003,11,UYIK1901CS,29105,22500,3.4,3,9116,16562,-6605,7446,-0.4
10,TMS13F1315P0008,12,UYIK1901CS,30663,10467,4.8,2,15478,16208,-20196,730,-2.8
10,TMS13F1376P0018,13,UYIK1901CS,33315,20306,3.8,NA,9182,13510,-13009,4328,NA
10,TMS13F1400P0001,14,UYIK1901CS,39259,9124,4.9,4,13448,15844,-30135,2396,-0.9
10,TMS13F1461P0002,15,UYIK1901CS,40275,12305,4.9,6,13118,18250,-27970,5132,1.1
10,TMS13F2061P0005,16,UYIK1901CS,34892,9470,4.9,4,13863,17604,-25422,3741,-0.9
10,TMS13F2207P0001,17,UYIK1901CS,43723,14417,4.7,6,12441,12938,-29306,497,1.3
10,TMS14F1001P0004,18,UYIK1901CS,36776,12462,4.8,4,12705,17042,-24314,4337,-0.8
10,TMS14F1013P0007,19,UYIK1901CS,33975,13963,4.4,4,10534,20740,-20012,10206,-0.4
10,TMS14F1014P0016,20,UYIK1901CS,31595,7933,3.9,2,11932,18635,-23662,6703,-1.9
10,TMS14F1014P0017,21,UYIK1901CS,33873,12565,4.6,2,14058,22208,-21308,8150,-2.6
10,TMS14F1016P0006,22,UYIK1901CS,42450,12251,4.8,16,12868,13167,-30199,299,11.2
10,TMS14F1019P0015,23,UYIK1901CS,34538,9023,4.8,3,12161,12615,-25515,454,-1.8
10,TMS14F1022P0003,24,UYIK1901CS,19941,18079,2.2,3,12273,15490,-1862,3217,0.8
10,TMS14F1022P0006,25,UYIK1901CS,42847,12260,4.8,10,12996,15344,-30587,2348,5.2
10,TMS14F1035P0004,26,UYIK1901CS,30141,15511,5,6,18105,9917,-14630,-8188,1
10,TMS14F1035P0007,27,UYIK1901CS,40981,14823,4.8,7,11248,14417,-26158,3169,2.2
10,TMS14F1036P0007,28,UYIK1901CS,40351,21210,4.8,7,12435,21156,-19141,8721,2.2
10,TMS14F1049P0001,29,UYIK1901CS,42811,11236,4.8,7,12907,17844,-31575,4937,2.2
10,TMS14F1098P0013,30,UYIK1901CS,37785,8262,4.9,5,13770,13615,-29523,-155,0.0999999999999996
10,TMS14F1120P0003,31,UYIK1901CS,32879,5172,5,5,15463,24344,-27707,8881,0
10,TMS14F1125P0010,32,UYIK1901CS,33507,14392,4.9,4,15205,14729,-19115,-476,-0.9
10,TMS14F1131P0001,33,UYIK1901CS,34228,18655,5,3,14250,16333,-15573,2083,-2
10,TMS14F1146P0002,34,UYIK1901CS,36283,11128,4.7,NA,9936,13802,-25155,3866,NA
10,TMS14F1159P0003,35,UYIK1901CS,33983,15063,4.9,4,12596,15719,-18920,3123,-0.9
10,TMS14F1194P0002,36,UYIK1901CS,34581,10931,4.3,NA,9688,14042,-23650,4354,NA
10,TMS14F1195P0004,37,UYIK1901CS,23333,14100,3.2,2,13486,41198,-9233,27712,-1.2
10,TMS14F1195P0005,38,UYIK1901CS,25424,12718,5.2,5,20446,18000,-12706,-2446,-0.2
10,TMS14F1196P0003,39,UYIK1901CS,36965,14175,4.2,2,12080,16167,-22790,4087,-2.2
10,TMS14F1208P0007,40,UYIK1901CS,35176,15382,5,7,16535,12469,-19794,-4066,2
10,TMS14F1223P0007,41,UYIK1901CS,34863,13558,4.9,4,13513,12583,-21305,-930,-0.9
10,TMS14F1224P0004,42,UYIK1901CS,26160,11915,5.1,2,21165,9302,-14245,-11863,-3.1
10,TMS14F1262P0002,43,UYIK1901CS,31181,14505,4.9,5,16028,15688,-16676,-340,0.0999999999999996
10,TMS14F1278P0003,44,UYIK1901CS,22221,13983,3.9,3,16701,14802,-8238,-1899,-0.9
10,TMS14F1285P0006,45,UYIK1901CS,32720,17355,4,2,10566,16323,-15365,5757,-2
10,TMS14F1285P0017,46,UYIK1901CS,37358,19085,4.8,NA,10057,11542,-18273,1485,NA
10,TMS14F1287P0008,47,UYIK1901CS,41336,16497,4.7,8,10670,15594,-24839,4924,3.3
10,TMS14F1288P0008,48,UYIK1901CS,21644,6484,2.1,1,8537,5729,-15160,-2808,-1.1
10,TMS14F1291P0003,49,UYIK1901CS,36780,16887,4.7,NA,10100,11458,-19893,1358,NA
10,TMS14F1291P0011,50,UYIK1901CS,37117,14628,4.8,NA,10654,10281,-22489,-373,NA
10,TMS14F1291P0012,51,UYIK1901CS,35574,13887,4.9,8,14722,13625,-21687,-1097,3.1
10,TMS14F1292P0012,52,UYIK1901CS,24723,9926,3.4,3,13805,19198,-14797,5393,-0.4
10,TMS14F1295P0012,53,UYIK1901CS,20227,14246,2.1,2,11404,13385,-5981,1981,-0.1
10,TMS14F1297P0019,54,UYIK1901CS,40592,14079,4.7,5,11050,20021,-26513,8971,0.3
10,TMS14F1299P0007,55,UYIK1901CS,40834,14422,4.8,4,12042,18469,-26412,6427,-0.8
10,TMS14F1300P0002,56,UYIK1901CS,36857,13643,4.7,NA,10029,17260,-23214,7231,NA
10,TMS14F1300P0008,57,UYIK1901CS,34857,10248,4.9,5,14866,17229,-24609,2363,0.0999999999999996
10,TMS14F1301P0004,58,UYIK1901CS,39168,17278,4.8,NA,10633,20552,-21890,9919,NA
10,TMS14F1301P0013,59,UYIK1901CS,38764,15587,4.9,10,12908,11677,-23177,-1231,5.1
10,TMS14F1303P0012,60,UYIK1901CS,40871,12946,4.8,10,10882,19104,-27925,8222,5.2
10,TMS14F1306P0008,61,UYIK1901CS,42724,12388,4.8,8,12756,10771,-30336,-1985,3.2
10,TMS14F1306P0015,62,UYIK1901CS,34484,16268,4.6,4,11731,16604,-18216,4873,-0.6
10,TMS14F1306P0020,63,UYIK1901CS,27889,19672,3.5,4,8387,16750,-8217,8363,0.5
10,TMS14F1310P0004,64,UYIK1901CS,36323,12884,4.9,6,14322,19073,-23439,4751,1.1
10,TMS14F1310P0015,65,UYIK1901CS,17472,17480,13.8,NA,18000,14458,8,-3542,NA
10,TMS14F1311P0002,66,UYIK1901CS,35804,12030,4.9,6,14552,15094,-23774,542,1.1
10,TMS14F1312P0003,67,UYIK1901CS,39538,10312,4.7,5,10615,19125,-29226,8510,0.3
11,IITA-TMS-IBA000070,1,UYMO1701CS,15252,16797,4.3,6,9746,9049,1545,-697,1.7
11,IITA-TMS-IBA30572,2,UYMO1701CS,11931,10704,4.2,3,10192,15417,-1227,5225,-1.2
11,IITA-TMS-IBA980581,3,UYMO1701CS,12318,12369,4,6,8899,17681,51,8782,2
11,IITA-TMS-IBA982101,4,UYMO1701CS,12738,7444,3.3,4,9142,13708,-5294,4566,0.7
11,TMEB419,5,UYMO1701CS,8881,15972,3.8,4,8818,11660,7091,2842,0.2
11,TMS13F1021P0008,6,UYMO1701CS,13975,8531,4,5,8670,11639,-5444,2969,1
11,TMS13F1049P0001,7,UYMO1701CS,9063,7800,1.7,2,8783,11889,-1263,3106,0.3
11,TMS13F1114P0001,8,UYMO1701CS,13453,10079,4.4,5,10026,11611,-3374,1585,0.6
11,TMS13F1182P0002,9,UYMO1701CS,14260,15094,4.2,6,7762,10639,834,2877,1.8
11,TMS13F1304P0003,10,UYMO1701CS,9829,18686,2.7,3,6452,8569,8857,2117,0.3
11,TMS13F1315P0008,11,UYMO1701CS,10893,8925,3.8,2,10870,19611,-1968,8741,-1.8
11,TMS13F1376P0018,12,UYMO1701CS,11752,17788,2.4,NA,7214,8361,6036,1147,NA
11,TMS13F1400P0001,13,UYMO1701CS,15176,5785,4.2,4,9770,14403,-9391,4633,-0.2
11,TMS13F1461P0002,14,UYMO1701CS,15115,10067,4.3,6,9256,15312,-5048,6056,1.7
11,TMS13F2061P0005,15,UYMO1701CS,12890,12299,3.9,4,9958,13542,-591,3584,0.1
11,TMS13F2207P0001,16,UYMO1701CS,14215,12450,4.3,6,8263,12639,-1765,4376,1.7
11,TMS14F1001P0004,17,UYMO1701CS,13791,6765,3.6,4,9136,6181,-7026,-2955,0.4
11,TMS14F1013P0007,18,UYMO1701CS,11335,12743,3.1,4,7414,12431,1408,5017,0.9
11,TMS14F1014P0016,19,UYMO1701CS,10500,13458,2.6,2,8514,13625,2958,5111,-0.6
11,TMS14F1016P0006,20,UYMO1701CS,15656,15886,4.2,16,8825,12486,230,3661,11.8
11,TMS14F1019P0015,21,UYMO1701CS,13151,12242,3.1,3,8884,13347,-909,4463,-0.1
11,TMS14F1022P0003,22,UYMO1701CS,5241,11321,1.6,3,8747,12458,6080,3711,1.4
11,TMS14F1022P0006,23,UYMO1701CS,15689,15653,4.2,10,8798,11597,-36,2799,5.8
11,TMS14F1035P0004,24,UYMO1701CS,13754,17833,5,6,12373,12292,4079,-81,1
11,TMS14F1035P0007,25,UYMO1701CS,15228,16348,4.2,7,8205,10708,1120,2503,2.8
11,TMS14F1036P0007,26,UYMO1701CS,14666,14760,4.2,7,8719,11361,94,2642,2.8
11,TMS14F1049P0001,27,UYMO1701CS,15306,10861,4.2,7,8846,9938,-4445,1092,2.8
11,TMS14F1098P0013,28,UYMO1701CS,14497,8925,4,5,9783,10208,-5572,425,1
11,TMS14F1120P0003,29,UYMO1701CS,14378,7229,4.7,5,12021,11986,-7149,-35,0.3
11,TMS14F1125P0010,30,UYMO1701CS,14185,13474,4.7,4,11201,16750,-711,5549,-0.7
11,TMS14F1131P0001,31,UYMO1701CS,12747,4995,3.7,3,10372,5986,-7752,-4386,-0.7
11,TMS14F1146P0002,32,UYMO1701CS,13554,6269,3,NA,7825,15000,-7285,7175,NA
11,TMS14F1159P0003,33,UYMO1701CS,13083,10811,3.8,4,9387,8569,-2272,-818,0.2
11,TMS14F1194P0002,34,UYMO1701CS,13245,9669,2.8,NA,7616,6222,-3576,-1394,NA
11,TMS14F1195P0004,35,UYMO1701CS,7566,7333,2.1,2,9460,8903,-233,-557,-0.1
11,TMS14F1195P0005,36,UYMO1701CS,13571,9142,5.1,5,13123,9986,-4429,-3137,-0.0999999999999996
11,TMS14F1196P0003,37,UYMO1701CS,12976,11194,3.3,2,7724,14028,-1782,6304,-1.3
11,TMS14F1208P0007,38,UYMO1701CS,14179,8812,5,7,11584,9861,-5367,-1723,2
11,TMS14F1223P0007,39,UYMO1701CS,14369,13914,3.8,4,10070,12153,-455,2083,0.2
11,TMS14F1224P0004,40,UYMO1701CS,10535,13576,4.8,2,13903,15972,3041,2069,-2.8
11,TMS14F1262P0002,41,UYMO1701CS,12813,18812,4.3,5,12142,13611,5999,1469,0.7
11,TMS14F1278P0003,42,UYMO1701CS,6125,13181,2.1,3,11239,11667,7056,428,0.9
11,TMS14F1285P0017,43,UYMO1701CS,14790,14627,3.3,NA,8261,11236,-163,2975,NA
11,TMS14F1287P0008,44,UYMO1701CS,13306,16594,4.3,8,7362,9167,3288,1805,3.7
11,TMS14F1291P0003,45,UYMO1701CS,13795,17010,3.2,NA,7914,8542,3215,628,NA
11,TMS14F1291P0011,46,UYMO1701CS,14534,15027,3.4,NA,8185,10410,493,2225,NA
11,TMS14F1291P0012,47,UYMO1701CS,15078,12417,4.8,8,10951,12431,-2661,1480,3.2
11,TMS14F1292P0012,48,UYMO1701CS,8260,8110,2.1,3,9716,11667,-150,1951,0.9
11,TMS14F1295P0012,49,UYMO1701CS,6003,9434,1.2,2,7967,9444,3431,1477,0.8
11,TMS14F1297P0019,50,UYMO1701CS,11792,17569,4.1,5,7148,13312,5777,6164,0.9
11,TMS14F1299P0007,51,UYMO1701CS,15108,10811,4.2,4,8659,14931,-4297,6272,-0.2
11,TMS14F1300P0002,52,UYMO1701CS,13955,9065,3.2,NA,7968,7889,-4890,-79,NA
11,TMS14F1300P0008,53,UYMO1701CS,14547,7721,4.7,5,11034,14340,-6826,3306,0.3
11,TMS14F1301P0004,54,UYMO1701CS,15704,12262,4,NA,8537,17361,-3442,8824,NA
11,TMS14F1301P0013,55,UYMO1701CS,15150,13097,4.5,10,9516,14111,-2053,4595,5.5
11,TMS14F1303P0012,56,UYMO1701CS,14761,18230,4.2,10,7807,16875,3469,9068,5.8
11,TMS14F1306P0008,57,UYMO1701CS,14986,12415,4.2,8,8707,11194,-2571,2487,3.8
11,TMS14F1306P0015,58,UYMO1701CS,12620,7042,3.1,4,8474,8694,-5578,220,0.9
11,TMS14F1306P0020,59,UYMO1701CS,7630,13027,2.7,4,5908,13750,5397,7842,1.3
11,TMS14F1310P0004,60,UYMO1701CS,15467,7542,4.7,6,11148,7250,-7925,-3898,1.3
11,TMS14F1310P0015,61,UYMO1701CS,15134,19906,3.7,NA,8289,11111,4772,2822,NA
11,TMS14F1311P0002,62,UYMO1701CS,15824,10968,4.7,6,11308,10833,-4856,-475,1.3
11,TMS14F1312P0003,63,UYMO1701CS,12912,12708,4.1,5,7356,10986,-204,3630,0.9
12,IITA-TMS-IBA000070,1,UYMO1801CS,19543,10789,4.8,6,9510,12240,-8754,2730,1.2
12,IITA-TMS-IBA30572,2,UYMO1801CS,16474,6129,4.4,3,10044,9885,-10345,-159,-1.4
12,IITA-TMS-IBA980581,3,UYMO1801CS,21288,3790,4.7,6,8771,9323,-17498,552,1.3
12,IITA-TMS-IBA982101,4,UYMO1801CS,18429,1754,4.8,4,9039,3403,-16675,-5636,-0.8
12,TMEB419,5,UYMO1801CS,12566,8618,2.4,4,8950,8212,-3948,-738,1.6
12,TMS13F1021P0008,6,UYMO1801CS,20096,2441,4.8,5,8554,9375,-17655,821,0.2
12,TMS13F1049P0001,7,UYMO1801CS,11649,8594,2.8,2,9655,8403,-3055,-1252,-0.8
12,TMS13F1114P0001,8,UYMO1801CS,18844,3754,4.9,5,9792,5868,-15090,-3924,0.0999999999999996
12,TMS13F1126P0003,9,UYMO1801CS,12330,6064,4.9,4,12697,5139,-6266,-7558,-0.9
12,TMS13F1182P0002,10,UYMO1801CS,21205,4785,4.7,6,7707,9097,-16420,1390,1.3
12,TMS13F1304P0003,11,UYMO1801CS,15446,9967,3.4,3,6990,8889,-5479,1899,-0.4
12,TMS13F1315P0008,12,UYMO1801CS,13599,3807,3.9,2,10624,7847,-9792,-2777,-1.9
12,TMS13F1376P0018,13,UYMO1801CS,17257,14171,3.6,NA,6827,9028,-3086,2201,NA
12,TMS13F1400P0001,14,UYMO1801CS,19443,5897,4.8,4,8986,11389,-13546,2403,-0.8
12,TMS13F1461P0002,15,UYMO1801CS,20011,4134,4.8,6,8825,8576,-15877,-249,1.2
12,TMS13F2061P0005,16,UYMO1801CS,16977,5083,4.6,4,9421,9306,-11894,-115,-0.6
12,TMS13F2207P0001,17,UYMO1801CS,21524,8226,4.7,6,8134,9653,-13298,1519,1.3
12,TMS14F1001P0004,18,UYMO1801CS,18611,4271,4.8,4,8668,7986,-14340,-682,-0.8
12,TMS14F1013P0007,19,UYMO1801CS,17612,5991,4.2,4,7750,8611,-11621,861,-0.2
12,TMS14F1014P0016,20,UYMO1801CS,15259,5769,3.7,2,8888,11562,-9490,2674,-1.7
12,TMS14F1014P0017,21,UYMO1801CS,16235,7849,4.3,2,9021,7882,-8386,-1139,-2.3
12,TMS14F1016P0006,22,UYMO1801CS,20936,4966,4.8,16,8756,9410,-15970,654,11.2
12,TMS14F1019P0015,23,UYMO1801CS,17298,7160,4.7,3,9129,8194,-10138,-935,-1.7
12,TMS14F1022P0003,24,UYMO1801CS,8648,6502,2.2,3,9397,10799,-2146,1402,0.8
12,TMS14F1022P0006,25,UYMO1801CS,20946,7656,4.8,10,8642,6354,-13290,-2288,5.2
12,TMS14F1035P0004,26,UYMO1801CS,14594,9900,4.9,6,12835,9062,-4694,-3773,1.1
12,TMS14F1035P0007,27,UYMO1801CS,20774,8344,4.7,7,7907,5854,-12430,-2053,2.3
12,TMS14F1036P0007,28,UYMO1801CS,20150,5219,4.8,7,8591,8257,-14931,-334,2.2
12,TMS14F1049P0001,29,UYMO1801CS,21331,3752,4.7,7,8449,6389,-17579,-2060,2.3
12,TMS14F1098P0013,30,UYMO1801CS,19149,3917,4.8,5,9059,7847,-15232,-1212,0.2
12,TMS14F1120P0003,31,UYMO1801CS,15469,3047,4.9,5,11333,9340,-12422,-1993,0.0999999999999996
12,TMS14F1125P0010,32,UYMO1801CS,15906,6433,4.9,4,10969,10069,-9473,-900,-0.9
12,TMS14F1131P0001,33,UYMO1801CS,16571,3376,4.9,3,9823,8153,-13195,-1670,-1.9
12,TMS14F1146P0002,34,UYMO1801CS,18702,4249,4.6,NA,7072,6146,-14453,-926,NA
12,TMS14F1159P0003,35,UYMO1801CS,16759,8324,4.8,4,9530,10556,-8435,1026,-0.8
12,TMS14F1194P0002,36,UYMO1801CS,17960,4595,4.1,NA,7039,9958,-13365,2919,NA
12,TMS14F1195P0004,37,UYMO1801CS,10253,7532,3.1,2,10358,7118,-2721,-3240,-1.1
12,TMS14F1195P0005,38,UYMO1801CS,11824,3603,5.1,5,14554,10729,-8221,-3825,-0.0999999999999996
12,TMS14F1196P0003,39,UYMO1801CS,18149,10041,4.2,2,8103,9896,-8108,1793,-2.2
12,TMS14F1208P0007,40,UYMO1801CS,17119,5377,5,7,10408,8958,-11742,-1450,2
12,TMS14F1223P0007,41,UYMO1801CS,16755,6413,4.9,4,10011,8646,-10342,-1365,-0.9
12,TMS14F1224P0004,42,UYMO1801CS,10099,3259,5,2,14767,10243,-6840,-4524,-3
12,TMS14F1262P0002,43,UYMO1801CS,14704,2994,4.8,5,11486,8618,-11710,-2868,0.2
12,TMS14F1278P0003,44,UYMO1801CS,8467,6242,3.6,3,12651,9792,-2225,-2859,-0.6
12,TMS14F1285P0006,45,UYMO1801CS,16656,8174,3.8,2,7807,6910,-8482,-897,-1.8
12,TMS14F1285P0017,46,UYMO1801CS,19281,9972,4.8,NA,7256,10972,-9309,3716,NA
12,TMS14F1287P0008,47,UYMO1801CS,21329,15641,4.7,8,7545,13333,-5688,5788,3.3
12,TMS14F1288P0008,48,UYMO1801CS,11705,5883,2.1,1,6782,6771,-5822,-11,-1.1
12,TMS14F1291P0003,49,UYMO1801CS,18972,10291,4.7,NA,7148,8681,-8681,1533,NA
12,TMS14F1291P0011,50,UYMO1801CS,19247,7148,4.8,NA,7254,9625,-12099,2371,NA
12,TMS14F1291P0012,51,UYMO1801CS,17723,9991,4.9,8,10544,12674,-7732,2130,3.1
12,TMS14F1292P0012,52,UYMO1801CS,10702,6520,3.1,3,10560,12361,-4182,1801,-0.1
12,TMS14F1295P0012,53,UYMO1801CS,8797,5714,1.9,2,8767,9965,-3083,1198,0.1
12,TMS14F1297P0019,54,UYMO1801CS,20671,5531,4.7,5,7612,13646,-15140,6034,0.3
12,TMS14F1299P0007,55,UYMO1801CS,20241,6868,4.8,4,8301,8819,-13373,518,-0.8
12,TMS14F1300P0002,56,UYMO1801CS,18995,5678,4.7,NA,7147,7951,-13317,804,NA
12,TMS14F1300P0008,57,UYMO1801CS,17104,3035,4.8,5,10467,9271,-14069,-1196,0.2
12,TMS14F1301P0004,58,UYMO1801CS,19953,5157,4.8,NA,7363,8125,-14796,762,NA
12,TMS14F1301P0013,59,UYMO1801CS,19042,5814,4.9,10,8933,7014,-13228,-1919,5.1
12,TMS14F1303P0012,60,UYMO1801CS,20957,6791,4.7,10,7799,8681,-14166,882,5.3
12,TMS14F1306P0008,61,UYMO1801CS,21196,6910,4.7,8,8204,8924,-14286,720,3.3
12,TMS14F1306P0015,62,UYMO1801CS,17355,6474,4.3,4,8423,9688,-10881,1265,-0.3
12,TMS14F1306P0020,63,UYMO1801CS,16059,3091,3.4,4,6488,5486,-12968,-1002,0.6
12,TMS14F1310P0004,64,UYMO1801CS,17969,5573,4.9,6,10221,8438,-12396,-1783,1.1
12,TMS14F1310P0015,65,UYMO1801CS,19776,10689,4.8,NA,7295,10278,-9087,2983,NA
12,TMS14F1311P0002,66,UYMO1801CS,17513,6219,4.9,6,10535,8993,-11294,-1542,1.1
12,TMS14F1312P0003,67,UYMO1801CS,20638,5071,4.7,5,7496,11701,-15567,4205,0.3
13,IITA-TMS-IBA000070,1,UYMO1901CS,25178,8484,4.8,6,10617,7365,-16694,-3252,1.2
13,IITA-TMS-IBA30572,2,UYMO1901CS,23444,4657,4.2,3,11251,6219,-18787,-5032,-1.2
13,IITA-TMS-IBA980581,3,UYMO1901CS,26814,5315,4.7,6,10606,5802,-21499,-4804,1.3
13,IITA-TMS-IBA982101,4,UYMO1901CS,23713,4282,4.7,4,10064,3896,-19431,-6168,-0.7
13,TMEB419,5,UYMO1901CS,17998,7071,2.9,4,9616,7052,-10927,-2564,1.1
13,TMS13F1049P0001,6,UYMO1901CS,15288,4996,2.5,2,9693,7438,-10292,-2255,-0.5
13,TMS13F1126P0003,7,UYMO1901CS,18345,5334,4.9,4,12847,3094,-13011,-9753,-0.9
13,TMS13F1304P0003,8,UYMO1901CS,17856,8613,3.2,3,7233,5417,-9243,-1816,-0.2
13,TMS13F1315P0008,9,UYMO1901CS,18580,4764,3.4,2,11233,9396,-13816,-1837,-1.4
13,TMS13F1376P0018,10,UYMO1901CS,20586,6739,3.6,NA,7547,5583,-13847,-1964,NA
13,TMS13F1400P0001,11,UYMO1901CS,24500,5494,4.8,4,10394,9979,-19006,-415,-0.8
13,TMS14F1013P0007,12,UYMO1901CS,21019,4609,3.8,4,8292,6115,-16410,-2177,0.2
13,TMS14F1014P0016,13,UYMO1901CS,19621,5115,3.4,2,9388,9000,-14506,-388,-1.4
13,TMS14F1014P0017,14,UYMO1901CS,20968,4215,3.9,2,10675,5208,-16753,-5467,-1.9
13,TMS14F1019P0015,15,UYMO1901CS,22408,5214,4.4,3,9592,5729,-17194,-3863,-1.4
13,TMS14F1022P0003,16,UYMO1901CS,10964,8452,1.9,3,9517,6698,-2512,-2819,1.1
13,TMS14F1098P0013,17,UYMO1901CS,24513,4305,4.8,5,10653,7188,-20208,-3465,0.2
13,TMS14F1125P0010,18,UYMO1901CS,22765,7770,4.9,4,11639,10156,-14995,-1483,-0.9
13,TMS14F1146P0002,19,UYMO1901CS,22829,6330,4.5,NA,8046,9323,-16499,1277,NA
13,TMS14F1159P0003,20,UYMO1901CS,21872,6561,4.8,4,10169,9802,-15311,-367,-0.8
13,TMS14F1195P0004,21,UYMO1901CS,13585,5933,2.8,2,10361,6385,-7652,-3976,-0.8
13,TMS14F1196P0003,22,UYMO1901CS,23540,6982,3.9,2,9161,6385,-16558,-2776,-1.9
13,TMS14F1278P0003,23,UYMO1901CS,12492,7720,2.9,3,12253,5698,-4772,-6555,0.1
13,TMS14F1285P0006,24,UYMO1901CS,20071,5568,3.5,2,8492,3583,-14503,-4909,-1.5
13,TMS14F1287P0008,25,UYMO1901CS,24904,6914,4.7,8,8234,6354,-17990,-1880,3.3
13,TMS14F1288P0008,26,UYMO1901CS,13135,5633,2,1,6923,6406,-7502,-517,-1
13,TMS14F1291P0003,27,UYMO1901CS,23180,5736,4.7,NA,8104,3698,-17444,-4406,NA
13,TMS14F1291P0012,28,UYMO1901CS,23792,4950,4.8,8,11707,4615,-18842,-7092,3.2
13,TMS14F1292P0012,29,UYMO1901CS,14124,6567,2.7,3,10600,7312,-7557,-3288,0.3
13,TMS14F1295P0012,30,UYMO1901CS,11235,5895,1.7,2,8844,6990,-5340,-1854,0.3
13,TMS14F1299P0007,31,UYMO1901CS,24921,4544,4.7,4,9407,7031,-20377,-2376,-0.7
13,TMS14F1300P0002,32,UYMO1901CS,23217,6599,4.7,NA,8112,7167,-16618,-945,NA
13,TMS14F1301P0004,33,UYMO1901CS,24669,2970,4.8,NA,8478,3094,-21699,-5384,NA
13,TMS14F1301P0013,34,UYMO1901CS,24010,7930,4.8,10,10111,9177,-16080,-934,5.2
13,TMS14F1306P0008,35,UYMO1901CS,26198,5560,4.7,8,9706,6604,-20638,-3102,3.3
13,TMS14F1310P0015,36,UYMO1901CS,24314,6834,4.8,NA,8357,5417,-17480,-2940,NA
14,IITA-TMS-IBA000070,1,UYON1801CS,38730,8069,4.9,6,12771,4306,-30661,-8465,1.1
14,IITA-TMS-IBA30572,2,UYON1801CS,33047,3642,4.9,3,13763,2743,-29405,-11020,-1.9
14,IITA-TMS-IBA980581,3,UYON1801CS,38849,6387,4.9,6,13028,3715,-32462,-9313,1.1
14,IITA-TMS-IBA982101,4,UYON1801CS,35666,7930,4.8,4,11749,5573,-27736,-6176,-0.8
14,TMEB419,5,UYON1801CS,26936,6076,4.8,4,12568,3993,-20860,-8575,-0.8
14,TMS13F1021P0008,6,UYON1801CS,39405,3896,4.8,5,13038,3750,-35509,-9288,0.2
14,TMS13F1049P0001,7,UYON1801CS,24629,7059,2.8,2,11580,4028,-17570,-7552,-0.8
14,TMS13F1114P0001,8,UYON1801CS,37189,4295,4.9,5,12835,3125,-32894,-9710,0.0999999999999996
14,TMS13F1126P0003,9,UYON1801CS,26447,7184,5,4,15852,3403,-19263,-12449,-1
14,TMS13F1182P0002,10,UYON1801CS,40683,4904,4.7,6,10740,4688,-35779,-6052,1.3
14,TMS13F1304P0003,11,UYON1801CS,26838,5946,3.3,3,8555,4375,-20892,-4180,-0.3
14,TMS13F1315P0008,12,UYON1801CS,28257,6235,4.7,2,14235,4514,-22022,-9721,-2.7
14,TMS13F1376P0018,13,UYON1801CS,33487,10772,3.7,NA,9118,4653,-22715,-4465,NA
14,TMS13F1400P0001,14,UYON1801CS,38618,7081,4.8,4,12928,6458,-31537,-6470,-0.8
14,TMS13F1461P0002,15,UYON1801CS,39486,6315,4.8,6,12519,4236,-33171,-8283,1.2
14,TMS13F2061P0005,16,UYON1801CS,34145,6024,4.8,4,12812,4340,-28121,-8472,-0.8
14,TMS13F2207P0001,17,UYON1801CS,41653,6576,4.7,6,11697,4444,-35077,-7253,1.3
14,TMS14F1001P0004,18,UYON1801CS,36675,4154,4.8,4,11979,2847,-32521,-9132,-0.8
14,TMS14F1013P0007,19,UYON1801CS,32746,4578,4.1,4,9934,5417,-28168,-4517,-0.0999999999999996
14,TMS14F1014P0016,20,UYON1801CS,30287,4530,3.7,2,11055,3785,-25757,-7270,-1.7
14,TMS14F1014P0017,21,UYON1801CS,33174,6759,4.3,2,12959,4306,-26415,-8653,-2.3
14,TMS14F1016P0006,22,UYON1801CS,40984,6929,4.8,16,12181,3819,-34055,-8362,11.2
14,TMS14F1019P0015,23,UYON1801CS,33477,6160,4.7,3,11351,3715,-27317,-7636,-1.7
14,TMS14F1022P0003,24,UYON1801CS,19515,6968,2.1,3,11402,2917,-12547,-8485,0.9
14,TMS14F1022P0006,25,UYON1801CS,41186,5721,4.8,10,12404,2569,-35465,-9835,5.2
14,TMS14F1035P0004,26,UYON1801CS,28810,6234,5,6,16229,2847,-22576,-13382,1
14,TMS14F1035P0007,27,UYON1801CS,40752,4410,4.7,7,11049,3125,-36342,-7924,2.3
14,TMS14F1036P0007,28,UYON1801CS,40089,6534,4.8,7,11816,3333,-33555,-8483,2.2
14,TMS14F1049P0001,29,UYON1801CS,40956,3359,4.8,7,12059,2569,-37597,-9490,2.2
14,TMS14F1098P0013,30,UYON1801CS,37487,5043,4.8,5,12914,5660,-32444,-7254,0.2
14,TMS14F1120P0003,31,UYON1801CS,32047,4506,4.9,5,14185,3681,-27541,-10504,0.0999999999999996
14,TMS14F1125P0010,32,UYON1801CS,32482,7740,4.9,4,13475,4653,-24742,-8822,-0.9
14,TMS14F1131P0001,33,UYON1801CS,33643,5036,4.9,3,13036,1562,-28607,-11474,-1.9
14,TMS14F1146P0002,34,UYON1801CS,36107,7340,4.7,NA,9740,4097,-28767,-5643,NA
14,TMS14F1159P0003,35,UYON1801CS,32686,7989,4.8,4,11762,4688,-24697,-7074,-0.8
14,TMS14F1194P0002,36,UYON1801CS,34382,7103,4.2,NA,9635,3785,-27279,-5850,NA
14,TMS14F1195P0004,37,UYON1801CS,22317,6329,3,2,12332,3264,-15988,-9068,-1
14,TMS14F1195P0005,38,UYON1801CS,24061,5451,5.1,5,17671,2917,-18610,-14754,-0.0999999999999996
14,TMS14F1196P0003,39,UYON1801CS,35980,5316,4.1,2,11084,3229,-30664,-7855,-2.1
14,TMS14F1208P0007,40,UYON1801CS,32844,6379,5,7,15369,2222,-26465,-13147,2
14,TMS14F1223P0007,41,UYON1801CS,33176,6637,4.9,4,12539,2882,-26539,-9657,-0.9
14,TMS14F1224P0004,42,UYON1801CS,23343,4549,5.1,2,18622,2049,-18794,-16573,-3.1
14,TMS14F1262P0002,43,UYON1801CS,31364,5773,4.8,5,14898,2778,-25591,-12120,0.2
14,TMS14F1278P0003,44,UYON1801CS,21891,8525,3.5,3,14949,3854,-13366,-11095,-0.5
14,TMS14F1285P0006,45,UYON1801CS,31627,8452,3.8,2,9974,3785,-23175,-6189,-1.8
14,TMS14F1285P0017,46,UYON1801CS,37220,7416,4.8,NA,9820,3056,-29804,-6764,NA
14,TMS14F1287P0008,47,UYON1801CS,40183,8619,4.7,8,10194,5903,-31564,-4291,3.3
14,TMS14F1288P0008,48,UYON1801CS,20379,2441,2,1,8134,2969,-17938,-5165,-1
14,TMS14F1291P0003,49,UYON1801CS,36725,5304,4.7,NA,9953,3299,-31421,-6654,NA
14,TMS14F1291P0011,50,UYON1801CS,37220,4542,4.8,NA,10579,2569,-32678,-8010,NA
14,TMS14F1291P0012,51,UYON1801CS,35435,6043,4.9,8,13561,3681,-29392,-9880,3.1
14,TMS14F1292P0012,52,UYON1801CS,23584,5662,3.1,3,12802,7431,-17922,-5371,-0.1
14,TMS14F1295P0012,53,UYON1801CS,19759,7130,1.9,2,10667,4444,-12629,-6223,0.1
14,TMS14F1297P0019,54,UYON1801CS,39818,4801,4.7,5,10775,4236,-35017,-6539,0.3
14,TMS14F1299P0007,55,UYON1801CS,40247,6183,4.8,4,11695,4549,-34064,-7146,-0.8
14,TMS14F1300P0002,56,UYON1801CS,36740,6724,4.7,NA,9855,3750,-30016,-6105,NA
14,TMS14F1300P0008,57,UYON1801CS,35151,5870,4.9,5,13651,3681,-29281,-9970,0.0999999999999996
14,TMS14F1301P0004,58,UYON1801CS,39303,8143,4.8,NA,10566,5972,-31160,-4594,NA
14,TMS14F1301P0013,59,UYON1801CS,38825,11954,4.9,10,12274,5000,-26871,-7274,5.1
14,TMS14F1303P0012,60,UYON1801CS,40189,4298,4.7,10,10531,3715,-35891,-6816,5.3
14,TMS14F1306P0008,61,UYON1801CS,40941,8528,4.8,8,12029,5833,-32413,-6196,3.2
14,TMS14F1306P0015,62,UYON1801CS,34124,5368,4.3,4,11077,3889,-28756,-7188,-0.3
14,TMS14F1306P0020,63,UYON1801CS,26061,5900,3.4,4,8035,3056,-20161,-4979,0.6
14,TMS14F1310P0004,64,UYON1801CS,36795,4315,4.8,6,13252,2222,-32480,-11030,1.2
14,TMS14F1310P0015,65,UYON1801CS,18660,7757,11.8,NA,9708,4167,-10903,-5541,NA
14,TMS14F1311P0002,66,UYON1801CS,36206,2276,4.9,6,13518,3299,-33930,-10219,1.1
14,TMS14F1312P0003,67,UYON1801CS,38365,3433,4.7,5,10045,3264,-34932,-6781,0.3
15,IITA-TMS-IBA000070,1,UYUB1901CS,32750,5890,4.9,6,12645,2911,-26860,-9734,1.1
15,IITA-TMS-IBA30572,2,UYUB1901CS,29783,2950,4.8,3,14715,2349,-26833,-12366,-1.8
15,IITA-TMS-IBA980581,3,UYUB1901CS,34764,8477,4.9,6,13071,4526,-26287,-8545,1.1
15,IITA-TMS-IBA982101,4,UYUB1901CS,31518,6860,4.8,4,12198,5484,-24658,-6714,-0.8
15,TMEB419,5,UYUB1901CS,26185,7827,3.9,4,13200,4651,-18358,-8549,0.1
15,TMS13F1021P0008,6,UYUB1901CS,34593,5894,4.8,5,12324,4198,-28699,-8126,0.2
15,TMS13F1049P0001,7,UYUB1901CS,23454,4337,3.2,2,12258,3771,-19117,-8487,-1.2
15,TMS13F1114P0001,8,UYUB1901CS,31346,5761,4.9,5,13079,3792,-25585,-9287,0.0999999999999996
15,TMS13F1126P0003,9,UYUB1901CS,24694,2736,5.1,4,17528,1365,-21958,-16163,-1.1
15,TMS13F1182P0002,10,UYUB1901CS,35178,5582,4.7,6,10121,5146,-29596,-4975,1.3
15,TMS13F1304P0003,11,UYUB1901CS,26061,7087,3.4,3,8790,2198,-18974,-6592,-0.4
15,TMS13F1315P0008,12,UYUB1901CS,26908,4454,4.8,2,15228,3594,-22454,-11634,-2.8
15,TMS13F1376P0018,13,UYUB1901CS,29071,6524,3.8,NA,8429,2771,-22547,-5658,NA
15,TMS13F1400P0001,14,UYUB1901CS,32849,3110,4.9,4,12430,2802,-29739,-9628,-0.9
15,TMS13F1461P0002,15,UYUB1901CS,33868,4820,4.9,6,11968,4427,-29048,-7541,1.1
15,TMS13F2061P0005,16,UYUB1901CS,30504,4631,4.9,4,13690,3208,-25873,-10482,-0.9
15,TMS13F2207P0001,17,UYUB1901CS,36408,7111,4.7,6,11181,3708,-29297,-7473,1.3
15,TMS14F1001P0004,18,UYUB1901CS,32073,6279,4.8,4,12188,3573,-25794,-8615,-0.8
15,TMS14F1013P0007,19,UYUB1901CS,30761,4646,4.5,4,10261,2292,-26115,-7969,-0.5
15,TMS14F1014P0016,20,UYUB1901CS,27142,3903,4.1,2,11415,3073,-23239,-8342,-2.1
15,TMS14F1014P0017,21,UYUB1901CS,29999,4413,4.7,2,13497,2990,-25586,-10507,-2.7
15,TMS14F1016P0006,22,UYUB1901CS,34772,6473,4.8,16,11667,3042,-28299,-8625,11.2
15,TMS14F1019P0015,23,UYUB1901CS,29812,4175,4.8,3,11815,2010,-25637,-9805,-1.8
15,TMS14F1022P0003,24,UYUB1901CS,18656,4046,2.3,3,11863,2021,-14610,-9842,0.7
15,TMS14F1022P0006,25,UYUB1901CS,35085,5179,4.8,10,11620,2344,-29906,-9276,5.2
15,TMS14F1035P0004,26,UYUB1901CS,24795,5578,5,6,17599,1198,-19217,-16401,1
15,TMS14F1035P0007,27,UYUB1901CS,34564,5738,4.8,7,10321,2750,-28826,-7571,2.2
15,TMS14F1036P0007,28,UYUB1901CS,34139,9655,4.9,7,11477,4438,-24484,-7039,2.1
15,TMS14F1049P0001,29,UYUB1901CS,35627,4741,4.8,7,11805,3438,-30886,-8367,2.2
15,TMS14F1098P0013,30,UYUB1901CS,31960,3435,4.9,5,12645,1667,-28525,-10978,0.0999999999999996
15,TMS14F1120P0003,31,UYUB1901CS,27788,2502,5,5,15396,3490,-25286,-11906,0
15,TMS14F1125P0010,32,UYUB1901CS,28663,4207,4.9,4,14767,2958,-24456,-11809,-0.9
15,TMS14F1131P0001,33,UYUB1901CS,30068,3563,5,3,13866,1323,-26505,-12543,-2
15,TMS14F1146P0002,34,UYUB1901CS,31587,4359,4.7,NA,8996,2406,-27228,-6590,NA
15,TMS14F1159P0003,35,UYUB1901CS,29771,4441,4.9,4,12453,2167,-25330,-10286,-0.9
15,TMS14F1194P0002,36,UYUB1901CS,30216,7707,4.4,NA,8866,3656,-22509,-5210,NA
15,TMS14F1195P0004,37,UYUB1901CS,21186,4235,3.4,2,13046,2802,-16951,-10244,-1.4
15,TMS14F1195P0005,38,UYUB1901CS,22079,3151,5.2,5,19625,2177,-18928,-17448,-0.2
15,TMS14F1196P0003,39,UYUB1901CS,32113,4564,4.3,2,11358,1875,-27549,-9483,-2.3
15,TMS14F1208P0007,40,UYUB1901CS,28858,1884,5,7,15616,1365,-26974,-14251,2
15,TMS14F1223P0007,41,UYUB1901CS,29940,3619,4.9,4,13465,1646,-26321,-11819,-0.9
15,TMS14F1224P0004,42,UYUB1901CS,21329,1533,5.2,2,20873,875,-19796,-19998,-3.2
15,TMS14F1262P0002,43,UYUB1901CS,26194,7073,4.9,5,15287,3719,-19121,-11568,0.0999999999999996
15,TMS14F1278P0003,44,UYUB1901CS,20324,3997,4.1,3,16002,1969,-16327,-14033,-1.1
15,TMS14F1285P0006,45,UYUB1901CS,28674,5962,4,2,10198,3385,-22712,-6813,-2
15,TMS14F1285P0017,46,UYUB1901CS,32647,6661,4.8,NA,9210,1719,-25986,-7491,NA
15,TMS14F1287P0008,47,UYUB1901CS,35362,6121,4.7,8,9834,3938,-29241,-5896,3.3
15,TMS14F1288P0008,48,UYUB1901CS,19974,3388,2.1,1,8279,1969,-16586,-6310,-1.1
15,TMS14F1291P0003,49,UYUB1901CS,31948,3654,4.8,NA,9077,1188,-28294,-7889,NA
15,TMS14F1291P0011,50,UYUB1901CS,32472,4266,4.8,NA,9346,1562,-28206,-7784,NA
15,TMS14F1291P0012,51,UYUB1901CS,29329,1570,4.9,8,13807,1042,-27759,-12765,3.1
15,TMS14F1292P0012,52,UYUB1901CS,22265,6299,3.4,3,13544,5031,-15966,-8513,-0.4
15,TMS14F1295P0012,53,UYUB1901CS,18487,2903,2.2,2,11098,1969,-15584,-9129,-0.2
15,TMS14F1297P0019,54,UYUB1901CS,34526,7760,4.7,5,10122,5042,-26766,-5080,0.3
15,TMS14F1299P0007,55,UYUB1901CS,34085,2727,4.8,4,11100,3406,-31358,-7694,-0.8
15,TMS14F1300P0002,56,UYUB1901CS,32007,3702,4.8,NA,9068,3500,-28305,-5568,NA
15,TMS14F1300P0008,57,UYUB1901CS,29068,4783,4.9,5,13871,3344,-24285,-10527,0.0999999999999996
15,TMS14F1301P0004,58,UYUB1901CS,33909,6360,4.8,NA,9375,4594,-27549,-4781,NA
15,TMS14F1301P0013,59,UYUB1901CS,32245,6321,4.9,10,11884,2979,-25924,-8905,5.1
15,TMS14F1303P0012,60,UYUB1901CS,34630,8229,4.8,10,10048,4854,-26401,-5194,5.2
15,TMS14F1306P0008,61,UYUB1901CS,35658,3373,4.8,8,11541,2021,-32285,-9520,3.2
15,TMS14F1306P0015,62,UYUB1901CS,30592,6372,4.7,4,11457,4042,-24220,-7415,-0.7
15,TMS14F1306P0020,63,UYUB1901CS,26044,6167,3.5,4,8162,3208,-19877,-4954,0.5
15,TMS14F1310P0004,64,UYUB1901CS,30188,2344,4.9,6,13215,1573,-27844,-11642,1.1
15,TMS14F1310P0015,65,UYUB1901CS,22720,7352,12,NA,18366,2292,-15368,-16074,NA
15,TMS14F1311P0002,66,UYUB1901CS,29562,4818,4.9,6,13655,2802,-24744,-10853,1.1
15,TMS14F1312P0003,67,UYUB1901CS,33801,6777,4.7,5,9765,3292,-27024,-6473,0.3
16,IITA-TMS-IBA000070,1,UYUM1801CS,28171,12787,4.9,6,12553,5867,-15384,-6686,1.1
16,IITA-TMS-IBA30572,2,UYUM1801CS,23150,8286,4.8,3,13169,4792,-14864,-8377,-1.8
16,IITA-TMS-IBA980581,3,UYUM1801CS,30442,10270,4.8,6,12045,4979,-20172,-7066,1.2
16,IITA-TMS-IBA982101,4,UYUM1801CS,25710,11296,4.8,4,12026,5908,-14414,-6118,-0.8
16,TMEB419,5,UYUM1801CS,20765,10559,4.9,4,12122,5867,-10206,-6255,-0.9
16,TMS13F1021P0008,6,UYUM1801CS,27951,12816,4.8,5,11789,5562,-15135,-6227,0.2
16,TMS13F1049P0001,7,UYUM1801CS,18178,7662,3.1,2,11216,5385,-10516,-5831,-1.1
16,TMS13F1114P0001,8,UYUM1801CS,26247,9406,4.9,5,12951,6097,-16841,-6854,0.0999999999999996
16,TMS13F1126P0003,9,UYUM1801CS,18782,8086,5,4,15934,1865,-10696,-14069,-1
16,TMS13F1182P0002,10,UYUM1801CS,29151,14105,4.7,6,9644,8264,-15046,-1380,1.3
16,TMS13F1304P0003,11,UYUM1801CS,20721,13071,3.3,3,8107,6073,-7650,-2034,-0.3
16,TMS13F1315P0008,12,UYUM1801CS,20914,9765,4.4,2,14115,5542,-11149,-8573,-2.4
16,TMS13F1376P0018,13,UYUM1801CS,23144,18144,3.6,NA,8171,4729,-5000,-3442,NA
16,TMS13F1400P0001,14,UYUM1801CS,28236,6688,4.9,4,12267,3958,-21548,-8309,-0.9
16,TMS13F1461P0002,15,UYUM1801CS,29018,9691,4.8,6,11932,5972,-19327,-5960,1.2
16,TMS13F2061P0005,16,UYUM1801CS,23622,11640,4.8,4,13067,5194,-11982,-7873,-0.8
16,TMS13F2207P0001,17,UYUM1801CS,30480,8355,4.7,6,10879,4965,-22125,-5914,1.3
16,TMS14F1001P0004,18,UYUM1801CS,25693,12160,4.8,4,11682,5368,-13533,-6314,-0.8
16,TMS14F1013P0007,19,UYUM1801CS,23538,15761,4.2,4,9628,4302,-7777,-5326,-0.2
16,TMS14F1014P0016,20,UYUM1801CS,20984,8363,4,2,10688,4167,-12621,-6521,-2
16,TMS14F1014P0017,21,UYUM1801CS,22274,9764,4.6,2,12677,6458,-12510,-6219,-2.6
16,TMS14F1016P0006,22,UYUM1801CS,29453,10177,4.8,16,11503,4215,-19276,-7288,11.2
16,TMS14F1019P0015,23,UYUM1801CS,23289,13922,4.8,3,11239,6521,-9367,-4718,-1.8
16,TMS14F1022P0003,24,UYUM1801CS,14705,11612,2.3,3,10974,6500,-3093,-4474,0.7
16,TMS14F1022P0006,25,UYUM1801CS,29215,8804,4.8,10,11196,2167,-20411,-9029,5.2
16,TMS14F1035P0004,26,UYUM1801CS,21396,13321,5,6,15458,3840,-8075,-11618,1
16,TMS14F1035P0007,27,UYUM1801CS,28741,8873,4.8,7,9752,3486,-19868,-6266,2.2
16,TMS14F1036P0007,28,UYUM1801CS,28931,17930,4.8,7,11213,8264,-11001,-2949,2.2
16,TMS14F1049P0001,29,UYUM1801CS,31016,10140,4.8,7,11621,5250,-20876,-6371,2.2
16,TMS14F1098P0013,30,UYUM1801CS,27327,8260,4.8,5,12458,6125,-19067,-6333,0.2
16,TMS14F1120P0003,31,UYUM1801CS,21595,9982,5,5,14641,10201,-11613,-4440,0
16,TMS14F1125P0010,32,UYUM1801CS,21845,13858,4.9,4,13859,5344,-7987,-8515,-0.9
16,TMS14F1131P0001,33,UYUM1801CS,22455,16652,5,3,13370,3854,-5803,-9516,-2
16,TMS14F1146P0002,34,UYUM1801CS,25188,11267,4.6,NA,8744,4854,-13921,-3890,NA
16,TMS14F1159P0003,35,UYUM1801CS,23131,12048,4.9,4,12015,4854,-11083,-7161,-0.9
16,TMS14F1194P0002,36,UYUM1801CS,24023,12323,4.1,NA,8622,4486,-11700,-4136,NA
16,TMS14F1195P0004,37,UYUM1801CS,17030,8836,3.4,2,12025,3490,-8194,-8535,-1.4
16,TMS14F1195P0005,38,UYUM1801CS,18805,15091,5.1,5,16866,5118,-3714,-11748,-0.0999999999999996
16,TMS14F1196P0003,39,UYUM1801CS,23902,14333,4.1,2,10312,3542,-9569,-6770,-2.1
16,TMS14F1208P0007,40,UYUM1801CS,24763,11089,5,7,14069,3757,-13674,-10312,2
16,TMS14F1223P0007,41,UYUM1801CS,22958,12291,4.9,4,13018,3077,-10667,-9941,-0.9
16,TMS14F1224P0004,42,UYUM1801CS,16439,8220,5,2,17875,2285,-8219,-15590,-3
16,TMS14F1262P0002,43,UYUM1801CS,21613,13963,4.9,5,14852,5722,-7650,-9130,0.0999999999999996
16,TMS14F1278P0003,44,UYUM1801CS,15213,10586,3.9,3,14698,3948,-4627,-10750,-0.9
16,TMS14F1285P0006,45,UYUM1801CS,22094,7119,3.9,2,9523,5500,-14975,-4023,-1.9
16,TMS14F1285P0017,46,UYUM1801CS,26039,15644,4.8,NA,9028,4347,-10395,-4681,NA
16,TMS14F1287P0008,47,UYUM1801CS,28600,7134,4.7,8,9197,4635,-21466,-4562,3.3
16,TMS14F1288P0008,48,UYUM1801CS,16560,5279,2,1,7705,3469,-11281,-4236,-1
16,TMS14F1291P0003,49,UYUM1801CS,25526,12474,4.7,NA,8828,4156,-13052,-4672,NA
16,TMS14F1291P0011,50,UYUM1801CS,26052,10902,4.8,NA,9027,2542,-15150,-6485,NA
16,TMS14F1291P0012,51,UYUM1801CS,25415,12670,4.9,8,13521,6125,-12745,-7396,3.1
16,TMS14F1292P0012,52,UYUM1801CS,17961,11968,3.5,3,12551,8719,-5993,-3832,-0.5
16,TMS14F1295P0012,53,UYUM1801CS,14922,10475,2.1,2,10263,4438,-4447,-5825,-0.1
16,TMS14F1297P0019,54,UYUM1801CS,26852,10161,4.7,5,9247,5049,-16691,-4198,0.3
16,TMS14F1299P0007,55,UYUM1801CS,29210,9751,4.8,4,10730,4740,-19459,-5990,-0.8
16,TMS14F1300P0002,56,UYUM1801CS,25711,11465,4.7,NA,8879,5125,-14246,-3754,NA
16,TMS14F1300P0008,57,UYUM1801CS,24476,12127,4.8,5,13563,7604,-12349,-5959,0.2
16,TMS14F1301P0004,58,UYUM1801CS,28044,17391,4.8,NA,9373,10375,-10653,1002,NA
16,TMS14F1301P0013,59,UYUM1801CS,27434,11459,4.9,10,11689,6552,-15975,-5137,5.1
16,TMS14F1303P0012,60,UYUM1801CS,28222,7788,4.7,10,9433,4403,-20434,-5030,5.3
16,TMS14F1306P0008,61,UYUM1801CS,30949,11755,4.7,8,11250,5885,-19194,-5365,3.3
16,TMS14F1306P0015,62,UYUM1801CS,23694,16766,4.5,4,10826,4729,-6928,-6097,-0.5
16,TMS14F1306P0020,63,UYUM1801CS,19572,11382,3.4,4,7393,4410,-8190,-2983,0.6
16,TMS14F1310P0004,64,UYUM1801CS,25331,16940,4.9,6,13167,6924,-8391,-6243,1.1
16,TMS14F1310P0015,65,UYUM1801CS,27640,12707,4.8,NA,9169,4531,-14933,-4638,NA
16,TMS14F1311P0002,66,UYUM1801CS,24735,6898,5,6,13662,5569,-17837,-8093,1
16,TMS14F1312P0003,67,UYUM1801CS,26964,11860,4.7,5,9155,8639,-15104,-516,0.3
