source,Clone,TRNO,EXCODE,HWAMS,HWAMM,LAIXS,LAIXM,CWAMS,CWAMM,HWAMMS,CWAMMS,LAIXMS
1,IITA-TMS-IBA000070,1,UYAB1901CS,11809,12507,5.1,6,9565,4729,698,-4836,0.9
1,IITA-TMS-IBA30572,2,UYAB1901CS,7737,6274,4.5,3,14923,5089,-1463,-9834,-1.5
1,IITA-TMS-IBA980581,3,UYAB1901CS,7552,11533,5.6,6,12809,8870,3981,-3939,0.4
1,IITA-TMS-IBA982101,4,UYAB1901CS,10113,10920,3.7,4,12042,7715,807,-4327,0.3
1,TMEB419,5,UYAB1901CS,6526,8916,4.9,4,14000,4370,2390,-9630,-0.9
1,TMS13F1021P0008,6,UYAB1901CS,8510,8067,5,5,12362,8115,-443,-4247,0
1,TMS13F1049P0001,7,UYAB1901CS,9708,10512,2.4,2,12193,6135,804,-6058,-0.4
1,TMS13F1114P0001,8,UYAB1901CS,7093,7759,5.4,5,12368,4427,666,-7941,-0.4
1,TMS13F1126P0003,9,UYAB1901CS,8082,5977,4.8,4,11484,2427,-2105,-9057,-0.8
1,TMS13F1182P0002,10,UYAB1901CS,8577,8533,3.8,6,9618,6000,-44,-3618,2.2
1,TMS13F1304P0003,11,UYAB1901CS,13152,12525,2.5,3,8530,3740,-627,-4790,0.5
1,TMS13F1315P0008,12,UYAB1901CS,8512,5640,2.8,2,11984,4323,-2872,-7661,-0.8
1,TMS13F1376P0018,13,UYAB1901CS,19140,13900,2.2,NA,7615,4562,-5240,-3053,NA
1,TMS13F1400P0001,14,UYAB1901CS,5120,7969,5.2,4,12801,4448,2849,-8353,-1.2
1,TMS13F1461P0002,15,UYAB1901CS,5851,7804,6.1,6,12968,6260,1953,-6708,-0.0999999999999996
1,TMS13F2061P0005,16,UYAB1901CS,9855,4764,3.5,4,12195,3562,-5091,-8633,0.5
1,TMS13F2207P0001,17,UYAB1901CS,8664,11313,3.8,6,11043,7052,2649,-3991,2.2
1,TMS14F1001P0004,18,UYAB1901CS,9379,5800,3.7,4,10005,3698,-3579,-6307,0.3
1,TMS14F1013P0007,19,UYAB1901CS,10521,11555,3,4,9597,6604,1034,-2993,1
1,TMS14F1014P0016,20,UYAB1901CS,8964,8629,2.5,2,10170,4229,-335,-5941,-0.5
1,TMS14F1014P0017,21,UYAB1901CS,7701,9921,3.3,2,10903,4490,2220,-6413,-1.3
1,TMS14F1016P0006,22,UYAB1901CS,9379,8170,5.2,16,10239,3771,-1209,-6468,10.8
1,TMS14F1019P0015,23,UYAB1901CS,9400,9254,3.5,3,9064,3323,-146,-5741,-0.5
1,TMS14F1022P0003,24,UYAB1901CS,12539,8741,1.8,3,11589,3823,-3798,-7766,1.2
1,TMS14F1022P0006,25,UYAB1901CS,9408,4682,4.4,10,9115,2896,-4726,-6219,5.6
1,TMS14F1035P0004,26,UYAB1901CS,9319,9301,5.3,6,12858,3510,-18,-9348,0.7
1,TMS14F1035P0007,27,UYAB1901CS,8028,7294,5.6,7,9373,4010,-734,-5363,1.4
1,TMS14F1036P0007,28,UYAB1901CS,10978,10955,4.8,7,12970,5135,-23,-7835,2.2
1,TMS14F1049P0001,29,UYAB1901CS,6505,5659,4.2,7,10746,2885,-846,-7861,2.8
1,TMS14F1098P0013,30,UYAB1901CS,5168,11621,5.3,5,12299,5365,6453,-6934,-0.3
1,TMS14F1120P0003,31,UYAB1901CS,5143,9562,5.4,5,12643,9438,4419,-3205,-0.4
1,TMS14F1125P0010,32,UYAB1901CS,10175,8717,4.4,4,12553,4875,-1458,-7678,-0.4
1,TMS14F1131P0001,33,UYAB1901CS,10046,8332,4.1,3,11286,3760,-1714,-7526,-1.1
1,TMS14F1146P0002,34,UYAB1901CS,11678,11907,3.1,NA,4969,7125,229,2156,NA
1,TMS14F1159P0003,35,UYAB1901CS,10181,8694,3.7,4,9990,4177,-1487,-5813,0.3
1,TMS14F1194P0002,36,UYAB1901CS,14606,9571,2.7,NA,6370,3604,-5035,-2766,NA
1,TMS14F1195P0004,37,UYAB1901CS,8992,10319,2.1,2,11000,5656,1327,-5344,-0.1
1,TMS14F1195P0005,38,UYAB1901CS,7212,7242,4.9,5,16302,4677,30,-11625,0.0999999999999996
1,TMS14F1196P0003,39,UYAB1901CS,10410,7253,2.5,2,10309,2781,-3157,-7528,-0.5
1,TMS14F1208P0007,40,UYAB1901CS,6015,7058,6.1,7,13463,4469,1043,-8994,0.9
1,TMS14F1223P0007,41,UYAB1901CS,11920,10890,5.1,4,8769,3021,-1030,-5748,-1.1
1,TMS14F1224P0004,42,UYAB1901CS,5384,3236,5.5,2,13211,3240,-2148,-9971,-3.5
1,TMS14F1262P0002,43,UYAB1901CS,7016,10853,4.7,5,14260,3188,3837,-11072,0.3
1,TMS14F1278P0003,44,UYAB1901CS,11399,11563,2.4,3,8000,4010,164,-3990,0.6
1,TMS14F1285P0006,45,UYAB1901CS,8062,8929,2.4,2,6246,4479,867,-1767,-0.4
1,TMS14F1285P0017,46,UYAB1901CS,13248,10209,4.6,NA,4284,5635,-3039,1351,NA
1,TMS14F1287P0008,47,UYAB1901CS,11196,8607,6.2,8,7874,4125,-2589,-3749,1.8
1,TMS14F1288P0008,48,UYAB1901CS,6489,7132,1.2,1,5399,4479,643,-920,-0.2
1,TMS14F1291P0003,49,UYAB1901CS,13766,6426,3.1,NA,5482,3281,-7340,-2201,NA
1,TMS14F1291P0011,50,UYAB1901CS,11294,6336,3.1,NA,4654,1479,-4958,-3175,NA
1,TMS14F1291P0012,51,UYAB1901CS,7713,10386,5.6,8,11024,4094,2673,-6930,2.4
1,TMS14F1292P0012,52,UYAB1901CS,8777,7727,2.7,3,9998,5083,-1050,-4915,0.3
1,TMS14F1295P0012,53,UYAB1901CS,12374,9976,1.5,2,10315,4531,-2398,-5784,0.5
1,TMS14F1297P0019,54,UYAB1901CS,8216,7873,4.5,5,9411,5177,-343,-4234,0.5
1,TMS14F1299P0007,55,UYAB1901CS,6256,6009,5.1,4,11035,3583,-247,-7452,-1.1
1,TMS14F1300P0002,56,UYAB1901CS,11074,6889,2.8,NA,4683,3094,-4185,-1589,NA
1,TMS14F1300P0008,57,UYAB1901CS,8850,7991,4.7,5,14738,6917,-859,-7821,0.3
1,TMS14F1301P0004,58,UYAB1901CS,12897,9474,4.2,NA,7963,6948,-3423,-1015,NA
1,TMS14F1301P0013,59,UYAB1901CS,6499,14202,5.6,10,12562,6448,7703,-6114,4.4
1,TMS14F1303P0012,60,UYAB1901CS,9579,8397,5.1,10,10197,3510,-1182,-6687,4.9
1,TMS14F1306P0008,61,UYAB1901CS,7420,14532,4.4,8,10282,6823,7112,-3459,3.6
1,TMS14F1306P0015,62,UYAB1901CS,11326,6328,4.7,4,9312,6375,-4998,-2937,-0.7
1,TMS14F1306P0020,63,UYAB1901CS,12941,10362,2.9,4,6206,6708,-2579,502,1.1
1,TMS14F1310P0004,64,UYAB1901CS,7364,6618,6,6,10329,3948,-746,-6381,0
1,TMS14F1310P0015,65,UYAB1901CS,12770,9970,3.3,NA,4267,3219,-2800,-1048,NA
1,TMS14F1311P0002,66,UYAB1901CS,7045,11859,6.1,6,11571,4583,4814,-6988,-0.0999999999999996
1,TMS14F1312P0003,67,UYAB1901CS,8401,6853,4.5,5,8133,2438,-1548,-5695,0.5
2,IITA-TMS-IBA000070,1,UYAG1701CS,14539,12043,3.7,6,6556,9514,-2496,2958,2.3
2,IITA-TMS-IBA30572,2,UYAG1701CS,8396,8082,2.9,3,8454,11736,-314,3282,0.1
2,IITA-TMS-IBA980581,3,UYAG1701CS,7737,8787,4.4,6,8010,10312,1050,2302,1.6
2,IITA-TMS-IBA982101,4,UYAG1701CS,9495,8181,2.7,4,7737,12049,-1314,4312,1.3
2,TMEB419,5,UYAG1701CS,7295,11592,3.7,4,7088,10799,4297,3711,0.3
2,TMS13F1021P0008,6,UYAG1701CS,9909,11479,3.2,5,6767,10694,1570,3927,1.8
2,TMS13F1114P0001,7,UYAG1701CS,7383,11248,4,5,7307,11146,3865,3839,1
2,TMS13F1182P0002,8,UYAG1701CS,10337,10331,3,6,6407,10972,-6,4565,3
2,TMS13F1461P0002,9,UYAG1701CS,8164,11475,4.6,6,8608,13854,3311,5246,1.4
2,TMS13F2061P0005,10,UYAG1701CS,9638,7866,2.7,4,7865,10868,-1772,3003,1.3
2,TMS13F2207P0001,11,UYAG1701CS,10271,12267,2.9,6,6831,11736,1996,4905,3.1
2,TMS14F1001P0004,12,UYAG1701CS,9273,13704,2.6,4,6394,12500,4431,6106,1.4
2,TMS14F1016P0006,13,UYAG1701CS,10713,15349,3.8,16,6653,10938,4636,4285,12.2
2,TMS14F1022P0006,14,UYAG1701CS,10460,11593,3.2,10,5498,9896,1133,4398,6.8
2,TMS14F1035P0004,15,UYAG1701CS,12069,12298,5.2,6,9090,8542,229,-548,0.8
2,TMS14F1035P0007,16,UYAG1701CS,9324,11206,4,7,6856,9132,1882,2276,3
2,TMS14F1036P0007,17,UYAG1701CS,13095,13686,4.6,7,9434,11111,591,1677,2.4
2,TMS14F1049P0001,18,UYAG1701CS,8877,9120,3.1,7,6622,11076,243,4454,3.9
2,TMS14F1120P0003,19,UYAG1701CS,6199,10382,3.4,5,7902,12188,4183,4286,1.6
2,TMS14F1131P0001,20,UYAG1701CS,8623,13267,2.8,3,7533,14132,4644,6599,0.2
2,TMS14F1194P0002,21,UYAG1701CS,11190,11853,2,NA,5099,11389,663,6290,NA
2,TMS14F1195P0005,22,UYAG1701CS,12048,9328,4.8,5,10976,12222,-2720,1246,0.2
2,TMS14F1208P0007,23,UYAG1701CS,9997,9819,5,7,8728,9896,-178,1168,2
2,TMS14F1223P0007,24,UYAG1701CS,9839,11489,3.6,4,6432,7326,1650,894,0.4
2,TMS14F1224P0004,25,UYAG1701CS,7095,12467,3.7,2,8637,10312,5372,1675,-1.7
2,TMS14F1262P0002,26,UYAG1701CS,10832,11750,3.2,5,9109,13438,918,4329,1.8
2,TMS14F1285P0017,27,UYAG1701CS,11387,12114,3.4,NA,3541,8090,727,4549,NA
2,TMS14F1291P0011,28,UYAG1701CS,9170,9412,2.3,NA,3404,9757,242,6353,NA
2,TMS14F1297P0019,29,UYAG1701CS,7155,11493,3.6,5,6356,13889,4338,7533,1.4
2,TMS14F1300P0008,30,UYAG1701CS,12200,12724,3.2,5,9518,12118,524,2600,1.8
2,TMS14F1303P0012,31,UYAG1701CS,10730,13397,4.2,10,7604,14062,2667,6458,5.8
2,TMS14F1306P0015,32,UYAG1701CS,9023,14854,3.2,4,7034,11458,5831,4424,0.8
2,TMS14F1306P0020,33,UYAG1701CS,9757,11533,2.5,4,4845,12535,1776,7690,1.5
2,TMS14F1310P0004,34,UYAG1701CS,10158,12931,4.1,6,7092,10729,2773,3637,1.9
2,TMS14F1311P0002,35,UYAG1701CS,10000,8939,4.3,6,7726,11493,-1061,3767,1.7
2,TMS14F1312P0003,36,UYAG1701CS,7430,8899,3.7,5,5726,13229,1469,7503,1.3
3,IITA-TMS-IBA000070,1,UYAG1801CS,16124,9363,5.1,6,9190,11875,-6761,2685,0.9
3,IITA-TMS-IBA30572,2,UYAG1801CS,8212,10875,3.2,3,15028,7361,2663,-7667,-0.2
3,IITA-TMS-IBA980581,3,UYAG1801CS,9724,10706,4.6,6,12763,10035,982,-2728,1.4
3,IITA-TMS-IBA982101,4,UYAG1801CS,11267,7297,3.9,4,11901,8924,-3970,-2977,0.1
3,TMEB419,5,UYAG1801CS,7105,8675,4.9,4,14885,7812,1570,-7073,-0.9
3,TMS13F1049P0001,6,UYAG1801CS,9557,9826,2.5,2,12747,8021,269,-4726,-0.5
3,TMS13F1126P0003,7,UYAG1801CS,7455,11825,5.2,4,11940,10833,4370,-1107,-1.2
3,TMS13F1304P0003,8,UYAG1801CS,14168,8654,2.5,3,8702,15347,-5514,6645,0.5
3,TMS13F1315P0008,9,UYAG1801CS,8557,8824,2.8,2,12339,9201,267,-3138,-0.8
3,TMS13F1376P0018,10,UYAG1801CS,22796,8353,2.3,NA,7594,17500,-14443,9906,NA
3,TMS13F1400P0001,11,UYAG1801CS,8889,9093,5.5,4,12556,8507,204,-4049,-1.5
3,TMS14F1013P0007,12,UYAG1801CS,11570,8908,3,4,9713,9757,-2662,44,1
3,TMS14F1014P0016,13,UYAG1801CS,9310,9461,2.5,2,10371,9826,151,-545,-0.5
3,TMS14F1014P0017,14,UYAG1801CS,8976,10043,3.1,2,11103,6146,1067,-4957,-1.1
3,TMS14F1019P0015,15,UYAG1801CS,9677,8386,3.6,3,9209,8819,-1291,-390,-0.6
3,TMS14F1022P0003,16,UYAG1801CS,12610,11411,1.9,3,12036,10590,-1199,-1446,1.1
3,TMS14F1098P0013,17,UYAG1801CS,7763,11653,5.6,5,11132,10694,3890,-438,-0.6
3,TMS14F1125P0010,18,UYAG1801CS,10082,5822,4.7,4,12394,11736,-4260,-658,-0.7
3,TMS14F1146P0002,19,UYAG1801CS,13996,11944,3.1,NA,4693,10104,-2052,5411,NA
3,TMS14F1159P0003,20,UYAG1801CS,11103,8519,3.8,4,10054,9861,-2584,-193,0.2
3,TMS14F1195P0004,21,UYAG1801CS,8661,6875,2.2,2,11620,7326,-1786,-4294,-0.2
3,TMS14F1196P0003,22,UYAG1801CS,11106,5622,2.3,2,10630,9340,-5484,-1290,-0.3
3,TMS14F1278P0003,23,UYAG1801CS,11644,11138,2.6,3,8418,11806,-506,3388,0.4
3,TMS14F1285P0006,24,UYAG1801CS,9019,12467,2.3,2,6294,9340,3448,3046,-0.3
3,TMS14F1287P0008,25,UYAG1801CS,15755,7879,6.2,8,7016,11562,-7876,4546,1.8
3,TMS14F1288P0008,26,UYAG1801CS,7672,6927,1.2,1,5634,6250,-745,616,-0.2
3,TMS14F1291P0003,27,UYAG1801CS,16498,8065,3.1,NA,5412,11458,-8433,6046,NA
3,TMS14F1291P0012,28,UYAG1801CS,10310,7656,5.9,8,9859,10312,-2654,453,2.1
3,TMS14F1292P0012,29,UYAG1801CS,8857,9179,3,3,10184,8194,322,-1990,0
3,TMS14F1295P0012,30,UYAG1801CS,12641,8282,1.5,2,10729,12986,-4359,2257,0.5
3,TMS14F1299P0007,31,UYAG1801CS,10032,12852,5.1,4,10730,10417,2820,-313,-1.1
3,TMS14F1300P0002,32,UYAG1801CS,13366,12125,2.8,NA,4452,8958,-1241,4506,NA
3,TMS14F1301P0004,33,UYAG1801CS,16803,9939,4.3,NA,7635,9028,-6864,1393,NA
3,TMS14F1301P0013,34,UYAG1801CS,10087,7282,5.6,10,11979,10972,-2805,-1007,4.4
3,TMS14F1306P0008,35,UYAG1801CS,11348,10372,4.8,8,10094,9514,-976,-580,3.2
3,TMS14F1310P0015,36,UYAG1801CS,17197,8242,3.4,NA,4109,13438,-8955,9329,NA
4,IITA-TMS-IBA000070,1,UYAG1901CS,13974,19619,5.1,6,9076,8760,5645,-316,0.9
4,IITA-TMS-IBA30572,2,UYAG1901CS,6514,8813,3.4,3,15611,8854,2299,-6757,-0.4
4,IITA-TMS-IBA980581,3,UYAG1901CS,8056,12512,5,6,12393,14948,4456,2555,1
4,IITA-TMS-IBA982101,4,UYAG1901CS,9670,11663,3.6,4,12249,14062,1993,1813,0.4
4,TMEB419,5,UYAG1901CS,5620,15039,4.3,4,14586,15521,9419,935,-0.3
4,TMS13F1021P0008,6,UYAG1901CS,10191,16682,4.2,5,12125,18021,6491,5896,0.8
4,TMS13F1114P0001,7,UYAG1901CS,8057,13610,5.6,5,10684,9719,5553,-965,-0.6
4,TMS13F1182P0002,8,UYAG1901CS,10976,17438,3.9,6,9702,14990,6462,5288,2.1
4,TMS13F1461P0002,9,UYAG1901CS,8087,13776,6.2,6,11955,14438,5689,2483,-0.2
4,TMS13F2061P0005,10,UYAG1901CS,9144,14419,3.7,4,12297,13719,5275,1422,0.3
4,TMS13F2207P0001,11,UYAG1901CS,10201,14849,4,6,11299,11635,4648,336,2
4,TMS14F1001P0004,12,UYAG1901CS,9544,17138,3.7,4,9744,12479,7594,2735,0.3
4,TMS14F1016P0006,13,UYAG1901CS,11543,13427,5.4,16,9714,11458,1884,1744,10.6
4,TMS14F1022P0006,14,UYAG1901CS,11436,15874,4.5,10,8770,10031,4438,1261,5.5
4,TMS14F1035P0004,15,UYAG1901CS,8595,14998,5.3,6,12801,4875,6403,-7926,0.7
4,TMS14F1035P0007,16,UYAG1901CS,10811,11024,5.5,7,8737,8781,213,44,1.5
4,TMS14F1036P0007,17,UYAG1901CS,13214,18794,4.7,7,12323,13479,5580,1156,2.3
4,TMS14F1049P0001,18,UYAG1901CS,8517,12027,4.7,7,10571,8802,3510,-1769,2.3
4,TMS14F1120P0003,19,UYAG1901CS,4764,8021,5.3,5,12359,13802,3257,1443,-0.3
4,TMS14F1131P0001,20,UYAG1901CS,9498,14609,4.1,3,11179,9406,5111,-1773,-1.1
4,TMS14F1194P0002,21,UYAG1901CS,16162,15153,2.7,NA,6263,10333,-1009,4070,NA
4,TMS14F1195P0005,22,UYAG1901CS,6148,13425,4.9,5,16381,8771,7277,-7610,0.0999999999999996
4,TMS14F1208P0007,23,UYAG1901CS,7218,16267,6.2,7,13009,12646,9049,-363,0.8
4,TMS14F1223P0007,24,UYAG1901CS,11817,13773,5.1,4,8682,6448,1956,-2234,-1.1
4,TMS14F1224P0004,25,UYAG1901CS,4262,11968,5.6,2,13290,7167,7706,-6123,-3.6
4,TMS14F1262P0002,26,UYAG1901CS,7788,14109,4.8,5,13736,10906,6321,-2830,0.2
4,TMS14F1285P0017,27,UYAG1901CS,15088,18921,4.6,NA,3933,7521,3833,3588,NA
4,TMS14F1291P0011,28,UYAG1901CS,13060,15991,3,NA,4644,8604,2931,3960,NA
4,TMS14F1297P0019,29,UYAG1901CS,10262,14444,4.2,5,8937,11781,4182,2844,0.8
4,TMS14F1300P0008,30,UYAG1901CS,8924,16798,4.7,5,14314,16781,7874,2467,0.3
4,TMS14F1303P0012,31,UYAG1901CS,12746,13654,5.1,10,9541,14771,908,5230,4.9
4,TMS14F1306P0015,32,UYAG1901CS,12104,16788,4.5,4,8589,10719,4684,2130,-0.5
4,TMS14F1306P0020,33,UYAG1901CS,14704,11279,2.9,4,6205,8292,-3425,2087,1.1
4,TMS14F1310P0004,34,UYAG1901CS,8805,12511,6.1,6,9931,7854,3706,-2077,-0.0999999999999996
4,TMS14F1311P0002,35,UYAG1901CS,8037,15266,6.1,6,11127,11667,7229,540,-0.0999999999999996
4,TMS14F1312P0003,36,UYAG1901CS,10090,12932,4.2,5,7658,15990,2842,8332,0.8
5,IITA-TMS-IBA000070,1,UYIB1701CS,16081,15661,3.6,6,8461,6194,-420,-2267,2.4
5,IITA-TMS-IBA30572,2,UYIB1701CS,8924,13582,4,3,12689,9806,4658,-2883,-1
5,IITA-TMS-IBA980581,3,UYIB1701CS,8937,13842,5.6,6,10758,8542,4905,-2216,0.4
5,IITA-TMS-IBA982101,4,UYIB1701CS,11758,7992,2.9,4,10406,10153,-3766,-253,1.1
5,TMEB419,5,UYIB1701CS,7593,11333,4.9,4,11281,8542,3740,-2739,-0.9
5,TMS13F1021P0008,6,UYIB1701CS,10604,19392,4.4,5,10191,9375,8788,-816,0.6
5,TMS13F1114P0001,7,UYIB1701CS,8136,18939,4.8,5,10201,14028,10803,3827,0.2
5,TMS13F1182P0002,8,UYIB1701CS,11458,15216,2.8,6,8493,9375,3758,882,3.2
5,TMS13F1461P0002,9,UYIB1701CS,9223,16884,4.9,6,11053,10833,7661,-220,1.1
5,TMS13F2061P0005,10,UYIB1701CS,11803,15958,3.2,4,10775,10431,4155,-344,0.8
5,TMS13F2207P0001,11,UYIB1701CS,11024,19782,3.1,6,9696,8778,8758,-918,2.9
5,TMS14F1001P0004,12,UYIB1701CS,11280,12904,2.8,4,8474,7778,1624,-696,1.2
5,TMS14F1016P0006,13,UYIB1701CS,12075,12059,4.1,16,9001,5972,-16,-3029,11.9
5,TMS14F1022P0006,14,UYIB1701CS,11367,12197,3.6,10,7859,5792,830,-2067,6.4
5,TMS14F1035P0004,15,UYIB1701CS,13506,17063,5.2,6,10991,5417,3557,-5574,0.8
5,TMS14F1035P0007,16,UYIB1701CS,11029,16536,3.8,7,8517,5403,5507,-3114,3.2
5,TMS14F1036P0007,17,UYIB1701CS,14797,18896,4.3,7,11604,11042,4099,-562,2.7
5,TMS14F1049P0001,18,UYIB1701CS,9522,14606,3.7,7,9445,7778,5084,-1667,3.3
5,TMS14F1120P0003,19,UYIB1701CS,6973,6331,3.6,5,10934,8889,-642,-2045,1.4
5,TMS14F1194P0002,20,UYIB1701CS,14409,11147,1.9,NA,6014,11458,-3262,5444,NA
5,TMS14F1195P0005,21,UYIB1701CS,12944,15680,4.8,5,13843,9819,2736,-4024,0.2
5,TMS14F1223P0007,22,UYIB1701CS,12688,16931,3.3,4,7655,3778,4243,-3877,0.7
5,TMS14F1262P0002,23,UYIB1701CS,12160,11345,3.3,5,12353,9792,-815,-2561,1.7
5,TMS14F1285P0017,24,UYIB1701CS,14148,12776,3.3,NA,4187,5014,-1372,827,NA
5,TMS14F1291P0011,25,UYIB1701CS,11691,13975,2.1,NA,4325,4375,2284,50,NA
5,TMS14F1297P0019,26,UYIB1701CS,8798,5417,3.6,5,8123,5875,-3381,-2248,1.4
5,TMS14F1300P0008,27,UYIB1701CS,13270,16404,3.9,5,12611,12083,3134,-528,1.1
5,TMS14F1303P0012,28,UYIB1701CS,12638,14280,4,10,9259,8875,1642,-384,6
5,TMS14F1306P0015,29,UYIB1701CS,11682,12645,3.1,4,8148,8306,963,158,0.9
5,TMS14F1306P0020,30,UYIB1701CS,10957,17831,2.3,4,5524,8556,6874,3032,1.7
5,TMS14F1310P0004,31,UYIB1701CS,11183,11087,3.8,6,9255,4514,-96,-4741,2.2
5,TMS14F1311P0002,32,UYIB1701CS,10814,11535,4.1,6,10241,8819,721,-1422,1.9
5,TMS14F1312P0003,33,UYIB1701CS,8679,17394,3.5,5,7097,7958,8715,861,1.5
6,IITA-TMS-IBA000070,1,UYIB1801CS,18398,19598,3.8,6,9319,6726,1200,-2593,2.2
6,IITA-TMS-IBA30572,2,UYIB1801CS,10583,13945,3.9,3,13821,9823,3362,-3998,-0.9
6,IITA-TMS-IBA980581,3,UYIB1801CS,11086,13473,5.6,6,11111,8441,2387,-2670,0.4
6,IITA-TMS-IBA982101,4,UYIB1801CS,13622,12288,2.6,4,10868,9094,-1334,-1774,1.4
6,TMEB419,5,UYIB1801CS,8822,9208,5,4,12628,7983,386,-4645,-1
6,TMS13F1021P0008,6,UYIB1801CS,13112,20129,4.6,5,11207,7826,7017,-3381,0.4
6,TMS13F1049P0001,7,UYIB1801CS,10538,13441,1.8,2,10629,6681,2903,-3948,0.2
6,TMS13F1114P0001,8,UYIB1801CS,11199,15432,4.5,5,10510,8326,4233,-2184,0.5
6,TMS13F1182P0002,9,UYIB1801CS,12682,14316,2.9,6,8989,9674,1634,685,3.1
6,TMS13F1304P0003,10,UYIB1801CS,12651,19750,2.4,3,7689,6167,7099,-1522,0.6
6,TMS13F1315P0008,11,UYIB1801CS,10889,15883,2.3,2,11012,9514,4994,-1498,-0.3
6,TMS13F1376P0018,12,UYIB1801CS,23076,19474,1.7,NA,7769,4625,-3602,-3144,NA
6,TMS13F1400P0001,13,UYIB1801CS,12020,10535,3.9,4,11912,8514,-1485,-3398,0.1
6,TMS13F1461P0002,14,UYIB1801CS,12313,9234,5,6,11535,5264,-3079,-6271,1
6,TMS13F2061P0005,15,UYIB1801CS,13601,12111,2.9,4,11150,8090,-1490,-3060,1.1
6,TMS13F2207P0001,16,UYIB1801CS,13061,20434,3,6,10325,9271,7373,-1054,3
6,TMS14F1001P0004,17,UYIB1801CS,12740,19194,2.8,4,9187,8361,6454,-826,1.2
6,TMS14F1013P0007,18,UYIB1801CS,11685,13330,2.4,4,8816,6590,1645,-2226,1.6
6,TMS14F1016P0006,19,UYIB1801CS,14792,24604,4.3,16,9589,8194,9812,-1395,11.7
6,TMS14F1019P0015,20,UYIB1801CS,10519,18476,2.5,3,8209,7507,7957,-702,0.5
6,TMS14F1022P0003,21,UYIB1801CS,14028,17503,1.5,3,10471,5660,3475,-4811,1.5
6,TMS14F1022P0006,22,UYIB1801CS,13742,22827,3.8,10,8541,7590,9085,-951,6.2
6,TMS14F1035P0004,23,UYIB1801CS,15920,20330,5.2,6,11378,5917,4410,-5461,0.8
6,TMS14F1035P0007,24,UYIB1801CS,13192,20441,4,7,8553,6868,7249,-1685,3
6,TMS14F1036P0007,25,UYIB1801CS,18344,22640,4.8,7,12198,11278,4296,-920,2.2
6,TMS14F1049P0001,26,UYIB1801CS,11543,14082,3.9,7,10168,7576,2539,-2592,3.1
6,TMS14F1120P0003,27,UYIB1801CS,8462,12946,3.4,5,11392,7007,4484,-4385,1.6
6,TMS14F1125P0010,28,UYIB1801CS,13224,17841,2.9,4,11469,7368,4617,-4101,1.1
6,TMS14F1146P0002,29,UYIB1801CS,14802,16711,2.3,NA,5017,6208,1909,1191,NA
6,TMS14F1159P0003,30,UYIB1801CS,11997,11622,2.8,4,9313,6312,-375,-3001,1.2
6,TMS14F1194P0002,31,UYIB1801CS,17004,10323,2.1,NA,6462,7611,-6681,1149,NA
6,TMS14F1195P0004,32,UYIB1801CS,9036,10860,1.7,2,9607,7188,1824,-2419,0.3
6,TMS14F1195P0005,33,UYIB1801CS,14708,16551,4.9,5,15309,6819,1843,-8490,0.0999999999999996
6,TMS14F1223P0007,34,UYIB1801CS,14357,18802,3.6,4,7739,4861,4445,-2878,0.4
6,TMS14F1262P0002,35,UYIB1801CS,14209,18393,3.2,5,13428,7785,4184,-5643,1.8
6,TMS14F1278P0003,36,UYIB1801CS,12826,14786,1.6,3,7291,5507,1960,-1784,1.4
6,TMS14F1285P0017,37,UYIB1801CS,16754,17392,3.4,NA,4433,4604,638,171,NA
6,TMS14F1287P0008,38,UYIB1801CS,14741,17799,6.2,8,7764,9417,3058,1653,1.8
6,TMS14F1288P0008,39,UYIB1801CS,6942,13304,1.1,1,4971,9865,6362,4894,-0.1
6,TMS14F1291P0003,40,UYIB1801CS,17539,18923,2.3,NA,5800,5806,1384,6,NA
6,TMS14F1291P0011,41,UYIB1801CS,13476,5791,2.3,NA,4859,2698,-7685,-2161,NA
6,TMS14F1291P0012,42,UYIB1801CS,12894,14898,4.1,8,10149,5458,2004,-4691,3.9
6,TMS14F1295P0012,43,UYIB1801CS,11964,16071,1,2,9052,7792,4107,-1260,1
6,TMS14F1297P0019,44,UYIB1801CS,10233,9452,3.5,5,8419,7618,-781,-801,1.5
6,TMS14F1299P0007,45,UYIB1801CS,12503,13983,3.8,4,10094,9160,1480,-934,0.2
6,TMS14F1300P0002,46,UYIB1801CS,13960,15890,2.1,NA,4735,8219,1930,3484,NA
6,TMS14F1300P0008,47,UYIB1801CS,15754,15678,3.6,5,13579,9097,-76,-4482,1.4
6,TMS14F1301P0004,48,UYIB1801CS,18770,17950,3.1,NA,8353,8944,-820,591,NA
6,TMS14F1301P0013,49,UYIB1801CS,13659,16455,5.1,10,11235,7646,2796,-3589,4.9
6,TMS14F1303P0012,50,UYIB1801CS,14832,16499,4,10,9293,9042,1667,-251,6
6,TMS14F1306P0008,51,UYIB1801CS,13012,14478,3.8,8,9617,8427,1466,-1190,4.2
6,TMS14F1306P0015,52,UYIB1801CS,14432,19343,3.3,4,8191,8875,4911,684,0.7
6,TMS14F1306P0020,53,UYIB1801CS,12388,16770,2.6,4,5805,8583,4382,2778,1.4
6,TMS14F1310P0004,54,UYIB1801CS,13388,15842,4.1,6,9816,5514,2454,-4302,1.9
6,TMS14F1310P0015,55,UYIB1801CS,18010,19443,2.5,NA,4505,7521,1433,3016,NA
6,TMS14F1311P0002,56,UYIB1801CS,13175,18289,4.3,6,10848,9243,5114,-1605,1.7
6,TMS14F1312P0003,57,UYIB1801CS,10503,17622,3.5,5,7298,7229,7119,-69,1.5
7,IITA-TMS-IBA000070,1,UYIB1901CS,11153,10594,5.1,6,6738,6203,-559,-535,0.9
7,IITA-TMS-IBA30572,2,UYIB1901CS,5978,5542,2.9,3,11313,6526,-436,-4787,0.1
7,IITA-TMS-IBA980581,3,UYIB1901CS,6685,9403,4.8,6,9602,10750,2718,1148,1.2
7,IITA-TMS-IBA982101,4,UYIB1901CS,8245,6354,3.5,4,9750,9750,-1891,0,0.5
7,TMEB419,5,UYIB1901CS,5513,8395,3,4,9833,8286,2882,-1547,1
7,TMS13F1021P0008,6,UYIB1901CS,8688,6990,4.1,5,8658,7542,-1698,-1116,0.9
7,TMS13F1049P0001,7,UYIB1901CS,7076,4127,2.1,2,10446,4000,-2949,-6446,-0.1
7,TMS13F1114P0001,8,UYIB1901CS,6652,9634,5.3,5,8047,6479,2982,-1568,-0.3
7,TMS13F1126P0003,9,UYIB1901CS,5990,5852,4.7,4,9364,3708,-138,-5656,-0.7
7,TMS13F1182P0002,10,UYIB1901CS,8806,8842,3.8,6,7672,6604,36,-1068,2.2
7,TMS13F1304P0003,11,UYIB1901CS,10520,9367,2.5,3,7327,9042,-1153,1715,0.5
7,TMS13F1315P0008,12,UYIB1901CS,6650,9611,3,2,9571,14010,2961,4439,-1
7,TMS13F1376P0018,13,UYIB1901CS,18077,9116,2.2,NA,6603,4167,-8961,-2436,NA
7,TMS13F1400P0001,14,UYIB1901CS,6021,6642,5.2,4,9552,8750,621,-802,-1.2
7,TMS13F1461P0002,15,UYIB1901CS,6352,7763,6.2,6,9739,7594,1411,-2145,-0.2
7,TMS13F2061P0005,16,UYIB1901CS,8211,7934,3.4,4,9579,7500,-277,-2079,0.6
7,TMS13F2207P0001,17,UYIB1901CS,8338,8186,3.9,6,8429,9625,-152,1196,2.1
7,TMS14F1001P0004,18,UYIB1901CS,8365,9135,3.5,4,7647,7063,770,-584,0.5
7,TMS14F1013P0007,19,UYIB1901CS,9332,6900,2.8,4,8041,5583,-2432,-2458,1.2
7,TMS14F1014P0016,20,UYIB1901CS,7141,11528,2.3,2,8302,9375,4387,1073,-0.3
7,TMS14F1014P0017,21,UYIB1901CS,6460,9123,2.7,2,8356,8375,2663,19,-0.7
7,TMS14F1016P0006,22,UYIB1901CS,8912,8075,5.3,16,7207,6833,-837,-374,10.7
7,TMS14F1019P0015,23,UYIB1901CS,7378,5059,3.1,3,7437,4865,-2319,-2572,-0.1
7,TMS14F1022P0003,24,UYIB1901CS,10121,11799,1.7,3,9994,8062,1678,-1932,1.3
7,TMS14F1022P0006,25,UYIB1901CS,8926,8631,4.3,10,6237,5094,-295,-1143,5.7
7,TMS14F1035P0004,26,UYIB1901CS,7107,11789,5.3,6,9776,5958,4682,-3818,0.7
7,TMS14F1035P0007,27,UYIB1901CS,8517,8289,5.5,7,7323,4719,-228,-2604,1.5
7,TMS14F1036P0007,28,UYIB1901CS,10048,11750,4.7,7,10213,8438,1702,-1775,2.3
7,TMS14F1049P0001,29,UYIB1901CS,7125,5750,4.5,7,7825,6948,-1375,-877,2.5
7,TMS14F1098P0013,30,UYIB1901CS,5523,13556,5.3,5,8768,6625,8033,-2143,-0.3
7,TMS14F1120P0003,31,UYIB1901CS,4109,6533,5.1,5,9875,8865,2424,-1010,-0.0999999999999996
7,TMS14F1125P0010,32,UYIB1901CS,7687,10161,4,4,9946,5875,2474,-4071,0
7,TMS14F1131P0001,33,UYIB1901CS,8512,8463,3.8,3,8967,5021,-49,-3946,-0.8
7,TMS14F1146P0002,34,UYIB1901CS,11076,6071,3.1,NA,3854,3625,-5005,-229,NA
7,TMS14F1159P0003,35,UYIB1901CS,8819,12483,3.4,4,8258,9979,3664,1721,0.6
7,TMS14F1194P0002,36,UYIB1901CS,13121,8727,2.7,NA,5358,9031,-4394,3673,NA
7,TMS14F1195P0004,37,UYIB1901CS,6391,9446,2,2,9534,8771,3055,-763,0
7,TMS14F1195P0005,38,UYIB1901CS,5511,8413,4.9,5,12684,7552,2902,-5132,0.0999999999999996
7,TMS14F1196P0003,39,UYIB1901CS,8061,10014,2.1,2,7667,4562,1953,-3105,-0.1
7,TMS14F1208P0007,40,UYIB1901CS,6119,9311,6.2,7,9652,7854,3192,-1798,0.8
7,TMS14F1223P0007,41,UYIB1901CS,9576,10530,4.7,4,7203,5396,954,-1807,-0.7
7,TMS14F1262P0002,42,UYIB1901CS,6902,12587,4.7,5,10960,8250,5685,-2710,0.3
7,TMS14F1278P0003,43,UYIB1901CS,9275,8371,2.2,3,6723,5510,-904,-1213,0.8
7,TMS14F1285P0006,44,UYIB1901CS,7269,10397,2.2,2,4998,6125,3128,1127,-0.2
7,TMS14F1285P0017,45,UYIB1901CS,12437,7439,4.7,NA,2962,5844,-4998,2882,NA
7,TMS14F1287P0008,46,UYIB1901CS,10835,13343,6.1,8,5832,9260,2508,3428,1.9
7,TMS14F1288P0008,47,UYIB1901CS,6009,4668,1.2,1,4526,8812,-1341,4286,-0.2
7,TMS14F1291P0003,48,UYIB1901CS,13024,3729,3.1,NA,4334,3792,-9295,-542,NA
7,TMS14F1291P0011,49,UYIB1901CS,11097,7678,3,NA,3001,5719,-3419,2718,NA
7,TMS14F1291P0012,50,UYIB1901CS,7005,7871,5.5,8,7825,7688,866,-137,2.5
7,TMS14F1292P0012,51,UYIB1901CS,6468,7440,2.5,3,8574,3979,972,-4595,0.5
7,TMS14F1295P0012,52,UYIB1901CS,9017,11089,1.3,2,8575,8115,2072,-460,0.7
7,TMS14F1297P0019,53,UYIB1901CS,7989,3812,4.2,5,7222,8562,-4177,1340,0.8
7,TMS14F1299P0007,54,UYIB1901CS,7030,10045,4.9,4,8548,6573,3015,-1975,-0.9
7,TMS14F1300P0002,55,UYIB1901CS,10530,8047,2.8,NA,3674,6719,-2483,3045,NA
7,TMS14F1300P0008,56,UYIB1901CS,7459,11321,4.7,5,10981,11125,3862,144,0.3
7,TMS14F1301P0004,57,UYIB1901CS,12601,10298,4.3,NA,6408,7104,-2303,696,NA
7,TMS14F1301P0013,58,UYIB1901CS,6698,10223,5.6,10,9742,7448,3525,-2294,4.4
7,TMS14F1303P0012,59,UYIB1901CS,9789,9121,5.1,10,8143,7979,-668,-164,4.9
7,TMS14F1306P0008,60,UYIB1901CS,7984,5865,4.6,8,7568,7094,-2119,-474,3.4
7,TMS14F1306P0015,61,UYIB1901CS,9867,8488,4.3,4,7398,8083,-1379,685,-0.3
7,TMS14F1306P0020,62,UYIB1901CS,11844,8737,2.9,4,5409,8146,-3107,2737,1.1
7,TMS14F1310P0004,63,UYIB1901CS,7034,6646,6.1,6,7593,4219,-388,-3374,-0.0999999999999996
7,TMS14F1310P0015,64,UYIB1901CS,13110,8580,3.4,NA,3093,5844,-4530,2751,NA
7,TMS14F1311P0002,65,UYIB1901CS,6636,8632,6.1,6,8509,6812,1996,-1697,-0.0999999999999996
7,TMS14F1312P0003,66,UYIB1901CS,8030,8801,4.2,5,6400,5292,771,-1108,0.8
8,IITA-TMS-IBA000070,1,UYIK1701CS,17019,13302,3.9,6,8579,7812,-3717,-767,2.1
8,IITA-TMS-IBA30572,2,UYIK1701CS,10361,9645,4,3,13034,8681,-716,-4353,-1
8,IITA-TMS-IBA980581,3,UYIK1701CS,10864,9302,5.5,6,11080,6111,-1562,-4969,0.5
8,IITA-TMS-IBA982101,4,UYIK1701CS,12648,9319,2.8,4,10625,8125,-3329,-2500,1.2
8,TMEB419,5,UYIK1701CS,8634,9350,4.7,4,11188,7292,716,-3896,-0.7
8,TMS13F1021P0008,6,UYIK1701CS,11633,12969,4,5,10185,9549,1336,-636,1
8,TMS13F1049P0001,7,UYIK1701CS,8808,NA,1.9,2,10206,NA,NA,NA,0.1
8,TMS13F1114P0001,8,UYIK1701CS,9565,7656,4.2,5,10166,7812,-1909,-2354,0.8
8,TMS13F1126P0003,9,UYIK1701CS,10087,NA,2.9,4,9959,NA,NA,NA,1.1
8,TMS13F1182P0002,10,UYIK1701CS,11306,9623,3.1,6,8511,8333,-1683,-178,2.9
8,TMS13F1304P0003,11,UYIK1701CS,11828,NA,2.4,3,7475,NA,NA,NA,0.6
8,TMS13F1315P0008,12,UYIK1701CS,10556,NA,2.5,2,10472,NA,NA,NA,-0.5
8,TMS13F1376P0018,13,UYIK1701CS,21161,NA,1.9,NA,7611,NA,NA,NA,NA
8,TMS13F1400P0001,14,UYIK1701CS,10303,NA,3.8,4,11152,NA,NA,NA,0.2
8,TMS13F1461P0002,15,UYIK1701CS,10604,12589,4.8,6,11008,10069,1985,-939,1.2
8,TMS13F2061P0005,16,UYIK1701CS,12652,12142,2.9,4,10938,7812,-510,-3126,1.1
8,TMS13F2207P0001,17,UYIK1701CS,11713,12067,3,6,9749,9514,354,-235,3
8,TMS14F1001P0004,18,UYIK1701CS,11612,13023,2.7,4,8798,7465,1411,-1333,1.3
8,TMS14F1013P0007,19,UYIK1701CS,10980,NA,2.4,4,8427,NA,NA,NA,1.6
8,TMS14F1014P0016,20,UYIK1701CS,9099,NA,2.1,2,8958,NA,NA,NA,-0.1
8,TMS14F1014P0017,21,UYIK1701CS,9164,NA,3.1,2,9626,NA,NA,NA,-1.1
8,TMS14F1016P0006,22,UYIK1701CS,12843,13842,4,16,8983,6458,999,-2525,12
8,TMS14F1019P0015,23,UYIK1701CS,9888,NA,2.7,3,8017,NA,NA,NA,0.3
8,TMS14F1022P0003,24,UYIK1701CS,12530,NA,1.5,3,9966,NA,NA,NA,1.5
8,TMS14F1022P0006,25,UYIK1701CS,11962,13724,3.4,10,7771,7188,1762,-583,6.6
8,TMS14F1035P0004,26,UYIK1701CS,15784,14428,5.2,6,11362,5347,-1356,-6015,0.8
8,TMS14F1035P0007,27,UYIK1701CS,11237,8689,4.2,7,8275,5799,-2548,-2476,2.8
8,TMS14F1036P0007,28,UYIK1701CS,16524,14861,4.7,7,11816,9132,-1663,-2684,2.3
8,TMS14F1049P0001,29,UYIK1701CS,10268,8405,3.3,7,9240,5590,-1863,-3650,3.7
8,TMS14F1098P0013,30,UYIK1701CS,9228,NA,4.1,5,10399,NA,NA,NA,0.9
8,TMS14F1120P0003,31,UYIK1701CS,7157,5505,3.6,5,11020,9375,-1652,-1645,1.4
8,TMS14F1125P0010,32,UYIK1701CS,11934,NA,2.9,4,10978,NA,NA,NA,1.1
8,TMS14F1131P0001,33,UYIK1701CS,10639,10301,2.9,3,9904,3819,-338,-6085,0.1
8,TMS14F1146P0002,34,UYIK1701CS,12778,NA,2.6,NA,4802,NA,NA,NA,NA
8,TMS14F1159P0003,35,UYIK1701CS,11105,NA,2.9,4,8858,NA,NA,NA,1.1
8,TMS14F1194P0002,36,UYIK1701CS,15578,13380,2.3,NA,6257,7604,-2198,1347,NA
8,TMS14F1195P0004,37,UYIK1701CS,8048,NA,1.8,2,9318,NA,NA,NA,0.2
8,TMS14F1195P0005,38,UYIK1701CS,14675,12712,4.8,5,15312,9028,-1963,-6284,0.2
8,TMS14F1196P0003,39,UYIK1701CS,9633,NA,2.2,2,8810,NA,NA,NA,-0.2
8,TMS14F1208P0007,40,UYIK1701CS,11567,10433,5.8,7,12414,3993,-1134,-8421,1.2
8,TMS14F1223P0007,41,UYIK1701CS,13330,12435,3.8,4,7647,4965,-895,-2682,0.2
8,TMS14F1224P0004,42,UYIK1701CS,8728,15638,3.6,2,11614,7222,6910,-4392,-1.6
8,TMS14F1262P0002,43,UYIK1701CS,12566,13382,3.4,5,12588,7917,816,-4671,1.6
8,TMS14F1278P0003,44,UYIK1701CS,10740,NA,1.7,3,7044,NA,NA,NA,1.3
8,TMS14F1285P0006,45,UYIK1701CS,7786,NA,1.9,2,5586,NA,NA,NA,0.1
8,TMS14F1285P0017,46,UYIK1701CS,14535,10938,3.7,NA,4176,4931,-3597,755,NA
8,TMS14F1287P0008,47,UYIK1701CS,13920,NA,6.1,8,7446,NA,NA,NA,1.9
8,TMS14F1288P0008,48,UYIK1701CS,6300,NA,1.1,1,4611,NA,NA,NA,-0.1
8,TMS14F1291P0003,49,UYIK1701CS,15194,NA,2.6,NA,5410,NA,NA,NA,NA
8,TMS14F1291P0011,50,UYIK1701CS,12172,12982,2.5,NA,4428,4271,810,-157,NA
8,TMS14F1291P0012,51,UYIK1701CS,11216,NA,3.8,8,9538,NA,NA,NA,4.2
8,TMS14F1292P0012,52,UYIK1701CS,9061,NA,2.2,3,8449,NA,NA,NA,0.8
8,TMS14F1295P0012,53,UYIK1701CS,10509,NA,1.1,2,8606,NA,NA,NA,0.9
8,TMS14F1297P0019,54,UYIK1701CS,9215,9642,3.6,5,8257,7396,427,-861,1.4
8,TMS14F1299P0007,55,UYIK1701CS,10666,NA,3.7,4,9656,NA,NA,NA,0.3
8,TMS14F1300P0002,56,UYIK1701CS,11913,NA,2.4,NA,4541,NA,NA,NA,NA
8,TMS14F1300P0008,57,UYIK1701CS,13962,10278,3.4,5,13047,10069,-3684,-2978,1.6
8,TMS14F1301P0004,58,UYIK1701CS,16255,NA,3.5,NA,7940,NA,NA,NA,NA
8,TMS14F1301P0013,59,UYIK1701CS,12027,NA,5.1,10,11062,NA,NA,NA,4.9
8,TMS14F1303P0012,60,UYIK1701CS,12884,12290,4.3,10,9122,11215,-594,2093,5.7
8,TMS14F1306P0008,61,UYIK1701CS,11389,NA,3.4,8,8877,NA,NA,NA,4.6
8,TMS14F1306P0015,62,UYIK1701CS,12465,12603,3.3,4,8128,7917,138,-211,0.7
8,TMS14F1306P0020,63,UYIK1701CS,12076,12339,2.7,4,5708,8194,263,2486,1.3
8,TMS14F1310P0004,64,UYIK1701CS,11788,13128,4.3,6,9348,6424,1340,-2924,1.7
8,TMS14F1310P0015,65,UYIK1701CS,15489,NA,2.9,NA,4179,NA,NA,NA,NA
8,TMS14F1311P0002,66,UYIK1701CS,11566,7488,4.4,6,10356,8924,-4078,-1432,1.6
8,TMS14F1312P0003,67,UYIK1701CS,9320,10306,3.6,5,7208,9097,986,1889,1.4
9,IITA-TMS-IBA000070,1,UYIK1801CS,19364,8592,4.2,6,8534,7049,-10772,-1485,1.8
9,IITA-TMS-IBA30572,2,UYIK1801CS,11638,5876,2.3,3,13811,6476,-5762,-7335,0.7
9,IITA-TMS-IBA980581,3,UYIK1801CS,15096,7869,3.5,6,10678,8021,-7227,-2657,2.5
9,IITA-TMS-IBA982101,4,UYIK1801CS,14514,5607,2.9,4,10733,7396,-8907,-3337,1.1
9,TMEB419,5,UYIK1801CS,10071,5861,3.6,4,13167,6684,-4210,-6483,0.4
9,TMS13F1021P0008,6,UYIK1801CS,15572,7925,3.4,5,10854,6042,-7647,-4812,1.6
9,TMS13F1049P0001,7,UYIK1801CS,10975,4006,1.8,2,10845,6250,-6969,-4595,0.2
9,TMS13F1114P0001,8,UYIK1801CS,13994,4400,4.1,5,9351,5660,-9594,-3691,0.9
9,TMS13F1126P0003,9,UYIK1801CS,10931,3739,3.8,4,10348,6250,-7192,-4098,0.2
9,TMS13F1182P0002,10,UYIK1801CS,14067,5688,3.1,6,8682,8646,-8379,-36,2.9
9,TMS13F1304P0003,11,UYIK1801CS,14465,3453,2.1,3,7293,6875,-11012,-418,0.9
9,TMS13F1315P0008,12,UYIK1801CS,11416,3427,2.3,2,11033,4931,-7989,-6102,-0.3
9,TMS13F1376P0018,13,UYIK1801CS,24720,2781,1.9,NA,7071,9618,-21939,2547,NA
9,TMS13F1400P0001,14,UYIK1801CS,12712,5135,4.3,4,11156,3507,-7577,-7649,-0.3
9,TMS13F1461P0002,15,UYIK1801CS,14556,4215,5.3,6,10611,6771,-10341,-3840,0.7
9,TMS13F2061P0005,16,UYIK1801CS,14329,3889,2.8,4,11060,5000,-10440,-6060,1.2
9,TMS13F2207P0001,17,UYIK1801CS,14834,7814,3.1,6,10066,6319,-7020,-3747,2.9
9,TMS14F1001P0004,18,UYIK1801CS,14097,7219,3,4,8408,6528,-6878,-1880,1
9,TMS14F1013P0007,19,UYIK1801CS,13018,4941,2.4,4,8653,7639,-8077,-1014,1.6
9,TMS14F1014P0016,20,UYIK1801CS,10600,4983,2,2,9388,3819,-5617,-5569,0
9,TMS14F1014P0017,21,UYIK1801CS,11554,4033,2.3,2,9896,5625,-7521,-4271,-0.3
9,TMS14F1016P0006,22,UYIK1801CS,16588,4297,4.3,16,8581,3472,-12291,-5109,11.7
9,TMS14F1019P0015,23,UYIK1801CS,11580,4109,2.6,3,8093,5451,-7471,-2642,0.4
9,TMS14F1022P0003,24,UYIK1801CS,13731,3595,1.4,3,10064,6806,-10136,-3258,1.6
9,TMS14F1022P0006,25,UYIK1801CS,15129,4419,3.6,10,7918,3125,-10710,-4793,6.4
9,TMS14F1035P0004,26,UYIK1801CS,18097,6623,5.2,6,11354,3299,-11474,-8055,0.8
9,TMS14F1035P0007,27,UYIK1801CS,15267,5908,4.5,7,7766,4618,-9359,-3148,2.5
9,TMS14F1036P0007,28,UYIK1801CS,20854,8551,4.7,7,11402,6250,-12303,-5152,2.3
9,TMS14F1049P0001,29,UYIK1801CS,13096,4961,3.5,7,9556,5625,-8135,-3931,3.5
9,TMS14F1098P0013,30,UYIK1801CS,12548,6283,4.3,5,9538,7222,-6265,-2316,0.7
9,TMS14F1120P0003,31,UYIK1801CS,9567,4409,4.1,5,11099,6840,-5158,-4259,0.9
9,TMS14F1125P0010,32,UYIK1801CS,13899,4073,3.4,4,11367,7847,-9826,-3520,0.6
9,TMS14F1131P0001,33,UYIK1801CS,14563,7333,3.2,3,10116,3542,-7230,-6574,-0.2
9,TMS14F1146P0002,34,UYIK1801CS,15674,3753,2.5,NA,4302,5069,-11921,767,NA
9,TMS14F1159P0003,35,UYIK1801CS,12632,3970,2.9,4,9079,5660,-8662,-3419,1.1
9,TMS14F1194P0002,36,UYIK1801CS,18056,6165,2.2,NA,5810,4722,-11891,-1088,NA
9,TMS14F1195P0004,37,UYIK1801CS,9441,3264,1.7,2,9597,5625,-6177,-3972,0.3
9,TMS14F1195P0005,38,UYIK1801CS,15602,7439,4.8,5,15323,4965,-8163,-10358,0.2
9,TMS14F1196P0003,39,UYIK1801CS,13099,2812,1.8,2,9441,6181,-10287,-3260,0.2
9,TMS14F1208P0007,40,UYIK1801CS,14489,5716,5.7,7,12512,4965,-8773,-7547,1.3
9,TMS14F1223P0007,41,UYIK1801CS,16027,6286,4,4,7319,3819,-9741,-3500,0
9,TMS14F1224P0004,42,UYIK1801CS,9519,4560,4.5,2,12070,3993,-4959,-8077,-2.5
9,TMS14F1262P0002,43,UYIK1801CS,14149,8247,4.2,5,12774,4792,-5902,-7982,0.8
9,TMS14F1278P0003,44,UYIK1801CS,11898,2486,1.9,3,7300,5764,-9412,-1536,1.1
9,TMS14F1285P0006,45,UYIK1801CS,10071,4757,1.9,2,5497,6215,-5314,718,0.1
9,TMS14F1285P0017,46,UYIK1801CS,17749,8594,3.8,NA,3663,4722,-9155,1059,NA
9,TMS14F1287P0008,47,UYIK1801CS,19413,6694,6.1,8,6316,7812,-12719,1496,1.9
9,TMS14F1288P0008,48,UYIK1801CS,7340,2688,1,1,4857,3750,-4652,-1107,0
9,TMS14F1291P0003,49,UYIK1801CS,18211,3090,2.5,NA,5135,6389,-15121,1254,NA
9,TMS14F1291P0011,50,UYIK1801CS,15284,5147,2.5,NA,4429,3229,-10137,-1200,NA
9,TMS14F1291P0012,51,UYIK1801CS,13638,4538,4.3,8,9280,7743,-9100,-1537,3.7
9,TMS14F1292P0012,52,UYIK1801CS,10426,6875,2.2,3,8487,8750,-3551,263,0.8
9,TMS14F1295P0012,53,UYIK1801CS,12610,4193,1.1,2,9060,5868,-8417,-3192,0.9
9,TMS14F1297P0019,54,UYIK1801CS,14089,5438,3.4,5,7691,7361,-8651,-330,1.6
9,TMS14F1299P0007,55,UYIK1801CS,13650,5260,4.1,4,9595,8576,-8390,-1019,-0.0999999999999996
9,TMS14F1300P0002,56,UYIK1801CS,14749,5172,2.3,NA,4078,4896,-9577,818,NA
9,TMS14F1300P0008,57,UYIK1801CS,15764,5875,4,5,12963,6562,-9889,-6401,1
9,TMS14F1301P0004,58,UYIK1801CS,19813,6632,3.5,NA,7253,8160,-13181,907,NA
9,TMS14F1301P0013,59,UYIK1801CS,15669,5536,5.5,10,10343,7257,-10133,-3086,4.5
9,TMS14F1303P0012,60,UYIK1801CS,17861,6265,4.6,10,8434,6493,-11596,-1941,5.4
9,TMS14F1306P0008,61,UYIK1801CS,14135,5444,3.7,8,8925,6458,-8691,-2467,4.3
9,TMS14F1306P0015,62,UYIK1801CS,16427,8993,3.7,4,7194,7812,-7434,618,0.3
9,TMS14F1306P0020,63,UYIK1801CS,15460,7687,2.4,4,5451,6736,-7773,1285,1.6
9,TMS14F1310P0004,64,UYIK1801CS,13754,4867,4.9,6,8981,4722,-8887,-4259,1.1
9,TMS14F1310P0015,65,UYIK1801CS,18554,4184,2.8,NA,3822,7153,-14370,3331,NA
9,TMS14F1311P0002,66,UYIK1801CS,14192,6698,5.3,6,9959,5833,-7494,-4126,0.7
9,TMS14F1312P0003,67,UYIK1801CS,12786,6541,3.5,5,6578,6181,-6245,-397,1.5
10,IITA-TMS-IBA000070,1,UYIK1901CS,16425,17732,5,6,9466,14635,1307,5169,1
10,IITA-TMS-IBA30572,2,UYIK1901CS,7966,9587,2.6,3,15667,16328,1621,661,0.4
10,IITA-TMS-IBA980581,3,UYIK1901CS,10749,13494,4.3,6,12252,16901,2745,4649,1.7
10,IITA-TMS-IBA982101,4,UYIK1901CS,11418,12538,3.4,4,12412,19125,1120,6713,0.6
10,TMEB419,5,UYIK1901CS,6739,14040,4.2,4,14515,15729,7301,1214,-0.2
10,TMS13F1021P0008,6,UYIK1901CS,11911,10998,4,5,11952,12667,-913,715,1
10,TMS13F1049P0001,7,UYIK1901CS,9111,10896,2.1,2,12669,15240,1785,2571,-0.1
10,TMS13F1114P0001,8,UYIK1901CS,10002,9189,5,5,10610,14135,-813,3525,0
10,TMS13F1126P0003,9,UYIK1901CS,8236,14529,4.4,4,11927,15260,6293,3333,-0.4
10,TMS13F1182P0002,10,UYIK1901CS,12092,9945,3.7,6,10037,22875,-2147,12838,2.3
10,TMS13F1304P0003,11,UYIK1901CS,13477,22500,2.5,3,8618,16562,9023,7944,0.5
10,TMS13F1315P0008,12,UYIK1901CS,8165,10467,2.8,2,12459,16208,2302,3749,-0.8
10,TMS13F1376P0018,13,UYIK1901CS,24311,20306,2.2,NA,8020,13510,-4005,5490,NA
10,TMS13F1400P0001,14,UYIK1901CS,8663,9124,5,4,12553,15844,461,3291,-1
10,TMS13F1461P0002,15,UYIK1901CS,10167,12305,6.1,6,11843,18250,2138,6407,-0.0999999999999996
10,TMS13F2061P0005,16,UYIK1901CS,10991,9470,3.2,4,12204,17604,-1521,5400,0.8
10,TMS13F2207P0001,17,UYIK1901CS,11830,14417,3.6,6,11565,12938,2587,1373,2.4
10,TMS14F1001P0004,18,UYIK1901CS,11257,12462,3.4,4,9933,17042,1205,7109,0.6
10,TMS14F1013P0007,19,UYIK1901CS,11568,13963,2.8,4,9914,20740,2395,10826,1.2
10,TMS14F1014P0016,20,UYIK1901CS,9192,7933,2.3,2,10735,18635,-1259,7900,-0.3
10,TMS14F1014P0017,21,UYIK1901CS,8769,12565,2.7,2,11171,22208,3796,11037,-0.7
10,TMS14F1016P0006,22,UYIK1901CS,13719,12251,4.9,16,9792,13167,-1468,3375,11.1
10,TMS14F1019P0015,23,UYIK1901CS,9383,9023,3,3,9384,12615,-360,3231,0
10,TMS14F1022P0003,24,UYIK1901CS,12278,18079,1.6,3,11773,15490,5801,3717,1.4
10,TMS14F1022P0006,25,UYIK1901CS,13240,12260,4.2,10,9025,15344,-980,6319,5.8
10,TMS14F1035P0004,26,UYIK1901CS,11728,15511,5.3,6,12867,9917,3783,-2950,0.7
10,TMS14F1035P0007,27,UYIK1901CS,12615,14823,5.2,7,8748,14417,2208,5669,1.8
10,TMS14F1036P0007,28,UYIK1901CS,16042,21210,4.7,7,12517,21156,5168,8639,2.3
10,TMS14F1049P0001,29,UYIK1901CS,10040,11236,4.2,7,10821,17844,1196,7023,2.8
10,TMS14F1098P0013,30,UYIK1901CS,8338,8262,4.9,5,11025,13615,-76,2590,0.0999999999999996
10,TMS14F1120P0003,31,UYIK1901CS,5939,5172,4.8,5,12702,24344,-767,11642,0.2
10,TMS14F1125P0010,32,UYIK1901CS,10751,14392,3.8,4,12924,14729,3641,1805,0.2
10,TMS14F1131P0001,33,UYIK1901CS,10927,18655,3.6,3,11275,16333,7728,5058,-0.6
10,TMS14F1146P0002,34,UYIK1901CS,15055,11128,3.1,NA,4913,13802,-3927,8889,NA
10,TMS14F1159P0003,35,UYIK1901CS,10766,15063,3.3,4,10455,15719,4297,5264,0.7
10,TMS14F1194P0002,36,UYIK1901CS,17615,10931,2.7,NA,6541,14042,-6684,7501,NA
10,TMS14F1195P0004,37,UYIK1901CS,8108,14100,2,2,11220,41198,5992,29978,0
10,TMS14F1195P0005,38,UYIK1901CS,8574,12718,4.9,5,17003,18000,4144,997,0.0999999999999996
10,TMS14F1196P0003,39,UYIK1901CS,11445,14175,2.1,2,10586,16167,2730,5581,-0.1
10,TMS14F1208P0007,40,UYIK1901CS,9849,15382,6.2,7,13831,12469,5533,-1362,0.8
10,TMS14F1223P0007,41,UYIK1901CS,13648,13558,4.6,4,8407,12583,-90,4176,-0.6
10,TMS14F1224P0004,42,UYIK1901CS,5690,11915,5.1,2,13821,9302,6225,-4519,-3.1
10,TMS14F1262P0002,43,UYIK1901CS,9339,14505,4.7,5,14264,15688,5166,1424,0.3
10,TMS14F1278P0003,44,UYIK1901CS,10497,13983,2.1,3,8525,14802,3486,6277,0.9
10,TMS14F1285P0006,45,UYIK1901CS,9065,17355,2.1,2,6268,16323,8290,10055,-0.1
10,TMS14F1285P0017,46,UYIK1901CS,16785,19085,4.5,NA,4021,11542,2300,7521,NA
10,TMS14F1287P0008,47,UYIK1901CS,16580,16497,6.1,8,7069,15594,-83,8525,1.9
10,TMS14F1288P0008,48,UYIK1901CS,6997,6484,1.1,1,5600,5729,-513,129,-0.1
10,TMS14F1291P0003,49,UYIK1901CS,17654,16887,3.1,NA,5702,11458,-767,5756,NA
10,TMS14F1291P0011,50,UYIK1901CS,14298,14628,3,NA,4807,10281,330,5474,NA
10,TMS14F1291P0012,51,UYIK1901CS,10162,13887,5,8,10453,13625,3725,3172,3
10,TMS14F1292P0012,52,UYIK1901CS,8844,9926,2.4,3,9801,19198,1082,9397,0.6
10,TMS14F1295P0012,53,UYIK1901CS,11322,14246,1.3,2,10489,13385,2924,2896,0.7
10,TMS14F1297P0019,54,UYIK1901CS,11357,14079,3.9,5,8793,20021,2722,11228,1.1
10,TMS14F1299P0007,55,UYIK1901CS,10065,14422,4.7,4,10758,18469,4357,7711,-0.7
10,TMS14F1300P0002,56,UYIK1901CS,14298,13643,2.8,NA,4689,17260,-655,12571,NA
10,TMS14F1300P0008,57,UYIK1901CS,11016,10248,4.6,5,14445,17229,-768,2784,0.4
10,TMS14F1301P0004,58,UYIK1901CS,17852,17278,4.3,NA,8033,20552,-574,12519,NA
10,TMS14F1301P0013,59,UYIK1901CS,10969,15587,5.6,10,11681,11677,4618,-4,4.4
10,TMS14F1303P0012,60,UYIK1901CS,14267,12946,5.1,10,9534,19104,-1321,9570,4.9
10,TMS14F1306P0008,61,UYIK1901CS,11512,12388,4.4,8,10217,10771,876,554,3.6
10,TMS14F1306P0015,62,UYIK1901CS,13868,16268,4.1,4,8260,16604,2400,8344,-0.0999999999999996
10,TMS14F1306P0020,63,UYIK1901CS,14859,19672,2.9,4,6189,16750,4813,10561,1.1
10,TMS14F1310P0004,64,UYIK1901CS,10391,12884,5.8,6,10144,19073,2493,8929,0.2
10,TMS14F1310P0015,65,UYIK1901CS,18135,17480,3.4,NA,4315,14458,-655,10143,NA
10,TMS14F1311P0002,66,UYIK1901CS,9799,12030,6.1,6,11190,15094,2231,3904,-0.0999999999999996
10,TMS14F1312P0003,67,UYIK1901CS,11190,10312,4,5,7704,19125,-878,11421,1
11,IITA-TMS-IBA000070,1,UYMO1701CS,5812,16797,3,6,5789,9049,10985,3260,3
11,IITA-TMS-IBA30572,2,UYMO1701CS,2840,10704,2.5,3,8022,15417,7864,7395,0.5
11,IITA-TMS-IBA980581,3,UYMO1701CS,2204,12369,3.4,6,7090,17681,10165,10591,2.6
11,IITA-TMS-IBA982101,4,UYMO1701CS,3354,7444,2.2,4,7242,13708,4090,6466,1.8
11,TMEB419,5,UYMO1701CS,3931,15972,2.7,4,5855,11660,12041,5805,1.3
11,TMS13F1021P0008,6,UYMO1701CS,2925,8531,2.7,5,6405,11639,5606,5234,2.3
11,TMS13F1049P0001,7,UYMO1701CS,2041,7800,1.2,2,7544,11889,5759,4345,0.8
11,TMS13F1114P0001,8,UYMO1701CS,1604,10079,3,5,6786,11611,8475,4825,2
11,TMS13F1182P0002,9,UYMO1701CS,2107,15094,2.6,6,6551,10639,12987,4088,3.4
11,TMS13F1304P0003,10,UYMO1701CS,3461,18686,2,3,6198,8569,15225,2371,1
11,TMS13F1315P0008,11,UYMO1701CS,3347,8925,2,2,6945,19611,5578,12666,0
11,TMS13F1376P0018,12,UYMO1701CS,7392,17788,1.6,NA,6038,8361,10396,2323,NA
11,TMS13F1400P0001,13,UYMO1701CS,1797,5785,2.9,4,7620,14403,3988,6783,1.1
11,TMS13F1461P0002,14,UYMO1701CS,913,10067,3.7,6,7475,15312,9154,7837,2.3
11,TMS13F2061P0005,15,UYMO1701CS,4315,12299,2.2,4,7238,13542,7984,6304,1.8
11,TMS13F2207P0001,16,UYMO1701CS,2410,12450,2.6,6,6550,12639,10040,6089,3.4
11,TMS14F1001P0004,17,UYMO1701CS,3393,6765,2.3,4,6177,6181,3372,4,1.7
11,TMS14F1013P0007,18,UYMO1701CS,2207,12743,2.1,4,6172,12431,10536,6259,1.9
11,TMS14F1014P0016,19,UYMO1701CS,1794,13458,1.6,2,6500,13625,11664,7125,0.4
11,TMS14F1016P0006,20,UYMO1701CS,3144,15886,3.2,16,6241,12486,12742,6245,12.8
11,TMS14F1019P0015,21,UYMO1701CS,2155,12242,2,3,6170,13347,10087,7177,1
11,TMS14F1022P0003,22,UYMO1701CS,2968,11321,1.2,3,7579,12458,8353,4879,1.8
11,TMS14F1022P0006,23,UYMO1701CS,3366,15653,2.7,10,5268,11597,12287,6329,7.3
11,TMS14F1035P0004,24,UYMO1701CS,4484,17833,4.8,6,8391,12292,13349,3901,1.2
11,TMS14F1035P0007,25,UYMO1701CS,2086,16348,3.6,7,6719,10708,14262,3989,3.4
11,TMS14F1036P0007,26,UYMO1701CS,3433,14760,3.7,7,8527,11361,11327,2834,3.3
11,TMS14F1049P0001,27,UYMO1701CS,1941,10861,2.7,7,6240,9938,8920,3698,4.3
11,TMS14F1098P0013,28,UYMO1701CS,1633,8925,2.9,5,7221,10208,7292,2987,2.1
11,TMS14F1120P0003,29,UYMO1701CS,333,7229,2.7,5,6862,11986,6896,5124,2.3
11,TMS14F1125P0010,30,UYMO1701CS,3169,13474,2.1,4,7854,16750,10305,8896,1.9
11,TMS14F1131P0001,31,UYMO1701CS,3303,4995,2.2,3,6914,5986,1692,-928,0.8
11,TMS14F1146P0002,32,UYMO1701CS,4532,6269,2.1,NA,4177,15000,1737,10823,NA
11,TMS14F1159P0003,33,UYMO1701CS,2613,10811,2.3,4,6542,8569,8198,2027,1.7
11,TMS14F1194P0002,34,UYMO1701CS,5483,9669,1.9,NA,5080,6222,4186,1142,NA
11,TMS14F1195P0004,35,UYMO1701CS,137,7333,1.3,2,5424,8903,7196,3479,0.7
11,TMS14F1195P0005,36,UYMO1701CS,3711,9142,4.7,5,10118,9986,5431,-132,0.3
11,TMS14F1196P0003,37,UYMO1701CS,2147,11194,1.7,2,5794,14028,9047,8234,0.3
11,TMS14F1208P0007,38,UYMO1701CS,2760,8812,3.9,7,7816,9861,6052,2045,3.1
11,TMS14F1223P0007,39,UYMO1701CS,3986,13914,2.8,4,6187,12153,9928,5966,1.2
11,TMS14F1224P0004,40,UYMO1701CS,1447,13576,2.9,2,8576,15972,12129,7396,-0.9
11,TMS14F1262P0002,41,UYMO1701CS,2514,18812,2.6,5,8768,13611,16298,4843,2.4
11,TMS14F1278P0003,42,UYMO1701CS,3419,13181,1.3,3,5432,11667,9762,6235,1.7
11,TMS14F1285P0017,43,UYMO1701CS,5979,14627,3.1,NA,3646,11236,8648,7590,NA
11,TMS14F1287P0008,44,UYMO1701CS,3173,16594,5.2,8,6237,9167,13421,2930,2.8
11,TMS14F1291P0003,45,UYMO1701CS,6276,17010,2.1,NA,4298,8542,10734,4244,NA
11,TMS14F1291P0011,46,UYMO1701CS,4712,15027,2.1,NA,3573,10410,10315,6837,NA
11,TMS14F1291P0012,47,UYMO1701CS,3094,12417,2.9,8,6647,12431,9323,5784,5.1
11,TMS14F1292P0012,48,UYMO1701CS,1068,8110,1.7,3,5969,11667,7042,5698,1.3
11,TMS14F1295P0012,49,UYMO1701CS,2564,9434,0.8,2,6407,9444,6870,3037,1.2
11,TMS14F1297P0019,50,UYMO1701CS,826,17569,3.2,5,6090,13312,16743,7222,1.8
11,TMS14F1299P0007,51,UYMO1701CS,1728,10811,2.9,4,7064,14931,9083,7867,1.1
11,TMS14F1300P0002,52,UYMO1701CS,4380,9065,1.9,NA,3951,7889,4685,3938,NA
11,TMS14F1300P0008,53,UYMO1701CS,3500,7721,2.5,5,9010,14340,4221,5330,2.5
11,TMS14F1301P0004,54,UYMO1701CS,4957,12262,2.7,NA,6433,17361,7305,10928,NA
11,TMS14F1301P0013,55,UYMO1701CS,1514,13097,3.9,10,8045,14111,11583,6066,6.1
11,TMS14F1303P0012,56,UYMO1701CS,2318,18230,3.7,10,7558,16875,15912,9317,6.3
11,TMS14F1306P0008,57,UYMO1701CS,2791,12415,2.8,8,6079,11194,9624,5115,5.2
11,TMS14F1306P0015,58,UYMO1701CS,3242,7042,3,4,6674,8694,3800,2020,1
11,TMS14F1306P0020,59,UYMO1701CS,3415,13027,2.3,4,4558,13750,9612,9192,1.7
11,TMS14F1310P0004,60,UYMO1701CS,2404,7542,3.2,6,6669,7250,5138,581,2.8
11,TMS14F1310P0015,61,UYMO1701CS,6515,19906,2.3,NA,3354,11111,13391,7757,NA
11,TMS14F1311P0002,62,UYMO1701CS,2287,10968,3.3,6,7436,10833,8681,3397,2.7
11,TMS14F1312P0003,63,UYMO1701CS,1524,12708,3.2,5,5782,10986,11184,5204,1.8
12,IITA-TMS-IBA000070,1,UYMO1801CS,7906,10789,4.4,6,5917,12240,2883,6323,1.6
12,IITA-TMS-IBA30572,2,UYMO1801CS,3527,6129,2.4,3,9116,9885,2602,769,0.6
12,IITA-TMS-IBA980581,3,UYMO1801CS,4775,3790,3.8,6,7353,9323,-985,1970,2.2
12,IITA-TMS-IBA982101,4,UYMO1801CS,5100,1754,3.2,4,8236,3403,-3346,-4833,0.8
12,TMEB419,5,UYMO1801CS,3045,8618,1.7,4,7099,8212,5573,1113,2.3
12,TMS13F1021P0008,6,UYMO1801CS,6125,2441,3.8,5,7012,9375,-3684,2363,1.2
12,TMS13F1049P0001,7,UYMO1801CS,3199,8594,1.9,2,8605,8403,5395,-202,0.1
12,TMS13F1114P0001,8,UYMO1801CS,4441,3754,4.4,5,6779,5868,-687,-911,0.6
12,TMS13F1126P0003,9,UYMO1801CS,3067,6064,3.2,4,7617,5139,2997,-2478,0.8
12,TMS13F1182P0002,10,UYMO1801CS,5568,4785,3.5,6,7166,9097,-783,1931,2.5
12,TMS13F1304P0003,11,UYMO1801CS,6983,9967,2.5,3,6797,8889,2984,2092,0.5
12,TMS13F1315P0008,12,UYMO1801CS,3564,3807,2.3,2,7547,7847,243,300,-0.3
12,TMS13F1376P0018,13,UYMO1801CS,12592,14171,2.1,NA,6304,9028,1579,2724,NA
12,TMS13F1400P0001,14,UYMO1801CS,3493,5897,4.2,4,8190,11389,2404,3199,-0.2
12,TMS13F1461P0002,15,UYMO1801CS,3457,4134,5.4,6,8454,8576,677,122,0.6
12,TMS13F2061P0005,16,UYMO1801CS,4999,5083,2.7,4,7926,9306,84,1380,1.3
12,TMS13F2207P0001,17,UYMO1801CS,5431,8226,3.5,6,7297,9653,2795,2356,2.5
12,TMS14F1001P0004,18,UYMO1801CS,5446,4271,3.2,4,6362,7986,-1175,1624,0.8
12,TMS14F1013P0007,19,UYMO1801CS,5804,5991,2.6,4,6879,8611,187,1732,1.4
12,TMS14F1014P0016,20,UYMO1801CS,4268,5769,2.2,2,7237,11562,1501,4325,-0.2
12,TMS14F1014P0017,21,UYMO1801CS,4074,7849,2.5,2,6734,7882,3775,1148,-0.5
12,TMS14F1016P0006,22,UYMO1801CS,5932,4966,4.7,16,6522,9410,-966,2888,11.3
12,TMS14F1019P0015,23,UYMO1801CS,4449,7160,2.8,3,6667,8194,2711,1527,0.2
12,TMS14F1022P0003,24,UYMO1801CS,5386,6502,1.6,3,8464,10799,1116,2335,1.4
12,TMS14F1022P0006,25,UYMO1801CS,6108,7656,3.9,10,5677,6354,1548,677,6.1
12,TMS14F1035P0004,26,UYMO1801CS,5893,9900,5.2,6,7811,9062,4007,1251,0.8
12,TMS14F1035P0007,27,UYMO1801CS,5056,8344,4.9,7,6929,5854,3288,-1075,2.1
12,TMS14F1036P0007,28,UYMO1801CS,6386,5219,4.7,7,9235,8257,-1167,-978,2.3
12,TMS14F1049P0001,29,UYMO1801CS,4507,3752,3.8,7,6653,6389,-755,-264,3.2
12,TMS14F1098P0013,30,UYMO1801CS,3116,3917,4.1,5,7459,7847,801,388,0.9
12,TMS14F1120P0003,31,UYMO1801CS,2010,3047,4.2,5,8133,9340,1037,1207,0.8
12,TMS14F1125P0010,32,UYMO1801CS,4645,6433,3.2,4,8253,10069,1788,1816,0.8
12,TMS14F1131P0001,33,UYMO1801CS,5244,3376,3.3,3,7074,8153,-1868,1079,-0.3
12,TMS14F1146P0002,34,UYMO1801CS,7552,4249,3,NA,3807,6146,-3303,2339,NA
12,TMS14F1159P0003,35,UYMO1801CS,5436,8324,3,4,7134,10556,2888,3422,1
12,TMS14F1194P0002,36,UYMO1801CS,9021,4595,2.6,NA,5089,9958,-4426,4869,NA
12,TMS14F1195P0004,37,UYMO1801CS,2696,7532,1.8,2,8361,7118,4836,-1243,0.2
12,TMS14F1195P0005,38,UYMO1801CS,4535,3603,4.8,5,9840,10729,-932,889,0.2
12,TMS14F1196P0003,39,UYMO1801CS,5331,10041,2.1,2,6540,9896,4710,3356,-0.1
12,TMS14F1208P0007,40,UYMO1801CS,4221,5377,5.3,7,8259,8958,1156,699,1.7
12,TMS14F1223P0007,41,UYMO1801CS,6253,6413,4,4,6132,8646,160,2514,0
12,TMS14F1224P0004,42,UYMO1801CS,1869,3259,3.9,2,8588,10243,1390,1655,-1.9
12,TMS14F1262P0002,43,UYMO1801CS,4158,2994,3.9,5,9126,8618,-1164,-508,1.1
12,TMS14F1278P0003,44,UYMO1801CS,5096,6242,1.8,3,5898,9792,1146,3894,1.2
12,TMS14F1285P0006,45,UYMO1801CS,4669,8174,2,2,4485,6910,3505,2425,0
12,TMS14F1285P0017,46,UYMO1801CS,8771,9972,4.5,NA,2817,10972,1201,8155,NA
12,TMS14F1287P0008,47,UYMO1801CS,7020,15641,6.1,8,5699,13333,8621,7634,1.9
12,TMS14F1288P0008,48,UYMO1801CS,3795,5883,1.1,1,4096,6771,2088,2675,-0.1
12,TMS14F1291P0003,49,UYMO1801CS,9195,10291,2.9,NA,4108,8681,1096,4573,NA
12,TMS14F1291P0011,50,UYMO1801CS,7557,7148,2.9,NA,2836,9625,-409,6789,NA
12,TMS14F1291P0012,51,UYMO1801CS,4462,9991,4.4,8,6762,12674,5529,5912,3.6
12,TMS14F1292P0012,52,UYMO1801CS,3129,6520,2.3,3,7327,12361,3391,5034,0.7
12,TMS14F1295P0012,53,UYMO1801CS,4806,5714,1.2,2,7244,9965,908,2721,0.8
12,TMS14F1297P0019,54,UYMO1801CS,4854,5531,3.9,5,6623,13646,677,7023,1.1
12,TMS14F1299P0007,55,UYMO1801CS,3999,6868,4.2,4,7640,8819,2869,1179,-0.2
12,TMS14F1300P0002,56,UYMO1801CS,7233,5678,2.7,NA,3656,7951,-1555,4295,NA
12,TMS14F1300P0008,57,UYMO1801CS,4563,3035,3.9,5,9582,9271,-1528,-311,1.1
12,TMS14F1301P0004,58,UYMO1801CS,8142,5157,4,NA,6191,8125,-2985,1934,NA
12,TMS14F1301P0013,59,UYMO1801CS,3613,5814,5.5,10,8916,7014,2201,-1902,4.5
12,TMS14F1303P0012,60,UYMO1801CS,5941,6791,5,10,7770,8681,850,911,5
12,TMS14F1306P0008,61,UYMO1801CS,5010,6910,3.8,8,6619,8924,1900,2305,4.2
12,TMS14F1306P0015,62,UYMO1801CS,5865,6474,4,4,6468,9688,609,3220,0
12,TMS14F1306P0020,63,UYMO1801CS,8495,3091,2.8,4,4940,5486,-5404,546,1.2
12,TMS14F1310P0004,64,UYMO1801CS,4363,5573,5,6,6875,8438,1210,1563,1
12,TMS14F1310P0015,65,UYMO1801CS,9273,10689,3.2,NA,3050,10278,1416,7228,NA
12,TMS14F1311P0002,66,UYMO1801CS,4003,6219,5.3,6,7454,8993,2216,1539,0.7
12,TMS14F1312P0003,67,UYMO1801CS,4984,5071,3.9,5,5963,11701,87,5738,1.1
13,IITA-TMS-IBA000070,1,UYMO1901CS,9414,8484,4.2,6,6663,7365,-930,702,1.8
13,IITA-TMS-IBA30572,2,UYMO1901CS,4947,4657,2.2,3,10324,6219,-290,-4105,0.8
13,IITA-TMS-IBA980581,3,UYMO1901CS,6290,5315,3.6,6,8437,5802,-975,-2635,2.4
13,IITA-TMS-IBA982101,4,UYMO1901CS,6535,4282,3,4,9071,3896,-2253,-5175,1
13,TMEB419,5,UYMO1901CS,4680,7071,1.7,4,8143,7052,2391,-1091,2.3
13,TMS13F1049P0001,6,UYMO1901CS,4415,4996,1.7,2,9167,7438,581,-1729,0.3
13,TMS13F1126P0003,7,UYMO1901CS,4659,5334,3.1,4,8171,3094,675,-5077,0.9
13,TMS13F1304P0003,8,UYMO1901CS,7874,8613,2.3,3,6993,5417,739,-1576,0.7
13,TMS13F1315P0008,9,UYMO1901CS,4675,4764,2,2,8621,9396,89,775,0
13,TMS13F1376P0018,10,UYMO1901CS,14403,6739,2.1,NA,6667,5583,-7664,-1084,NA
13,TMS13F1400P0001,11,UYMO1901CS,4465,5494,4,4,9350,9979,1029,629,0
13,TMS14F1013P0007,12,UYMO1901CS,6521,4609,2.4,4,7394,6115,-1912,-1279,1.6
13,TMS14F1014P0016,13,UYMO1901CS,4822,5115,2,2,7852,9000,293,1148,0
13,TMS14F1014P0017,14,UYMO1901CS,5116,4215,2.3,2,7787,5208,-901,-2579,-0.3
13,TMS14F1019P0015,15,UYMO1901CS,5498,5214,2.6,3,7077,5729,-284,-1348,0.4
13,TMS14F1022P0003,16,UYMO1901CS,6343,8452,1.4,3,8774,6698,2109,-2076,1.6
13,TMS14F1098P0013,17,UYMO1901CS,4521,4305,3.8,5,8370,7188,-216,-1182,1.2
13,TMS14F1125P0010,18,UYMO1901CS,6351,7770,2.9,4,9133,10156,1419,1023,1.1
13,TMS14F1146P0002,19,UYMO1901CS,8737,6330,2.9,NA,4082,9323,-2407,5241,NA
13,TMS14F1159P0003,20,UYMO1901CS,6195,6561,2.8,4,7780,9802,366,2022,1.2
13,TMS14F1195P0004,21,UYMO1901CS,3684,5933,1.7,2,8570,6385,2249,-2185,0.3
13,TMS14F1196P0003,22,UYMO1901CS,6532,6982,2,2,7231,6385,450,-846,0
13,TMS14F1278P0003,23,UYMO1901CS,5924,7720,1.5,3,6107,5698,1796,-409,1.5
13,TMS14F1285P0006,24,UYMO1901CS,5428,5568,1.9,2,4788,3583,140,-1205,0.1
13,TMS14F1287P0008,25,UYMO1901CS,8550,6914,6.1,8,6008,6354,-1636,346,1.9
13,TMS14F1288P0008,26,UYMO1901CS,3991,5633,1.1,1,4289,6406,1642,2117,-0.1
13,TMS14F1291P0003,27,UYMO1901CS,10549,5736,2.9,NA,4452,3698,-4813,-754,NA
13,TMS14F1291P0012,28,UYMO1901CS,5791,4950,4.1,8,7698,4615,-841,-3083,3.9
13,TMS14F1292P0012,29,UYMO1901CS,4212,6567,2,3,7386,7312,2355,-74,1
13,TMS14F1295P0012,30,UYMO1901CS,5564,5895,1,2,7711,6990,331,-721,1
13,TMS14F1299P0007,31,UYMO1901CS,5090,4544,3.9,4,8349,7031,-546,-1318,0.1
13,TMS14F1300P0002,32,UYMO1901CS,8305,6599,2.6,NA,3914,7167,-1706,3253,NA
13,TMS14F1301P0004,33,UYMO1901CS,9804,2970,4,NA,6654,3094,-6834,-3560,NA
13,TMS14F1301P0013,34,UYMO1901CS,5474,7930,5.5,10,9440,9177,2456,-263,4.5
13,TMS14F1306P0008,35,UYMO1901CS,6125,5560,3.7,8,7314,6604,-565,-710,4.3
13,TMS14F1310P0015,36,UYMO1901CS,10343,6834,3.2,NA,3271,5417,-3509,2146,NA
14,IITA-TMS-IBA000070,1,UYON1801CS,14865,8069,4.7,6,9323,4306,-6796,-5017,1.3
14,IITA-TMS-IBA30572,2,UYON1801CS,5798,3642,3.2,3,15852,2743,-2156,-13109,-0.2
14,IITA-TMS-IBA980581,3,UYON1801CS,9724,6387,5.2,6,11607,3715,-3337,-7892,0.8
14,IITA-TMS-IBA982101,4,UYON1801CS,10493,7930,3.2,4,11974,5573,-2563,-6401,0.8
14,TMEB419,5,UYON1801CS,5903,6076,3.3,4,12839,3993,173,-8846,0.7
14,TMS13F1021P0008,6,UYON1801CS,10573,3896,3.8,5,12287,3750,-6677,-8537,1.2
14,TMS13F1049P0001,7,UYON1801CS,8236,7059,1.9,2,12060,4028,-1177,-8032,0.1
14,TMS13F1114P0001,8,UYON1801CS,9675,4295,4.3,5,10291,3125,-5380,-7166,0.7
14,TMS13F1126P0003,9,UYON1801CS,6893,7184,4,4,11663,3403,291,-8260,0
14,TMS13F1182P0002,10,UYON1801CS,11300,4904,3.6,6,10113,4688,-6396,-5425,2.4
14,TMS13F1304P0003,11,UYON1801CS,12590,5946,2.4,3,8404,4375,-6644,-4029,0.6
14,TMS13F1315P0008,12,UYON1801CS,6757,6235,2.8,2,12503,4514,-522,-7989,-0.8
14,TMS13F1376P0018,13,UYON1801CS,24075,10772,2.2,NA,7923,4653,-13303,-3270,NA
14,TMS13F1400P0001,14,UYON1801CS,7792,7081,4.7,4,12907,6458,-711,-6449,-0.7
14,TMS13F1461P0002,15,UYON1801CS,10042,6315,5.9,6,11529,4236,-3727,-7293,0.0999999999999996
14,TMS13F2061P0005,16,UYON1801CS,9762,6024,3.1,4,12272,4340,-3738,-7932,0.9
14,TMS13F2207P0001,17,UYON1801CS,10582,6576,3.5,6,11637,4444,-4006,-7193,2.5
14,TMS14F1001P0004,18,UYON1801CS,10641,4154,3.2,4,9733,2847,-6487,-6886,0.8
14,TMS14F1013P0007,19,UYON1801CS,10476,4578,2.6,4,9741,5417,-5898,-4324,1.4
14,TMS14F1014P0016,20,UYON1801CS,8085,4530,2.2,2,10497,3785,-3555,-6712,-0.2
14,TMS14F1014P0017,21,UYON1801CS,7172,6759,2.5,2,11333,4306,-413,-7027,-0.5
14,TMS14F1016P0006,22,UYON1801CS,12828,6929,4.8,16,9463,3819,-5899,-5644,11.2
14,TMS14F1019P0015,23,UYON1801CS,8584,6160,2.8,3,9281,3715,-2424,-5566,0.2
14,TMS14F1022P0003,24,UYON1801CS,11667,6968,1.5,3,11321,2917,-4699,-8404,1.5
14,TMS14F1022P0006,25,UYON1801CS,12084,5721,4.1,10,8820,2569,-6363,-6251,5.9
14,TMS14F1035P0004,26,UYON1801CS,10874,6234,5.3,6,11998,2847,-4640,-9151,0.7
14,TMS14F1035P0007,27,UYON1801CS,12581,4410,5,7,8567,3125,-8171,-5442,2
14,TMS14F1036P0007,28,UYON1801CS,15543,6534,4.7,7,11972,3333,-9009,-8639,2.3
14,TMS14F1049P0001,29,UYON1801CS,9359,3359,4,7,10779,2569,-6000,-8210,3
14,TMS14F1098P0013,30,UYON1801CS,8289,5043,4.6,5,10721,5660,-3246,-5061,0.4
14,TMS14F1120P0003,31,UYON1801CS,5082,4506,4.1,5,12609,3681,-576,-8928,0.9
14,TMS14F1125P0010,32,UYON1801CS,9222,7740,3.5,4,12549,4653,-1482,-7896,0.5
14,TMS14F1131P0001,33,UYON1801CS,10371,5036,3.3,3,11032,1562,-5335,-9470,-0.3
14,TMS14F1146P0002,34,UYON1801CS,14777,7340,3.1,NA,4818,4097,-7437,-721,NA
14,TMS14F1159P0003,35,UYON1801CS,9775,7989,3.1,4,10369,4688,-1786,-5681,0.9
14,TMS14F1194P0002,36,UYON1801CS,17326,7103,2.7,NA,6426,3785,-10223,-2641,NA
14,TMS14F1195P0004,37,UYON1801CS,7361,6329,1.8,2,10872,3264,-1032,-7608,0.2
14,TMS14F1195P0005,38,UYON1801CS,6891,5451,4.9,5,16432,2917,-1440,-13515,0.0999999999999996
14,TMS14F1196P0003,39,UYON1801CS,9894,5316,2.1,2,10431,3229,-4578,-7202,-0.1
14,TMS14F1208P0007,40,UYON1801CS,7798,6379,6.2,7,13882,2222,-1419,-11660,0.8
14,TMS14F1223P0007,41,UYON1801CS,13025,6637,4.1,4,7965,2882,-6388,-5083,-0.0999999999999996
14,TMS14F1224P0004,42,UYON1801CS,4506,4549,4.8,2,13357,2049,43,-11308,-2.8
14,TMS14F1262P0002,43,UYON1801CS,8396,5773,4.3,5,14337,2778,-2623,-11559,0.7
14,TMS14F1278P0003,44,UYON1801CS,9576,8525,1.9,3,8375,3854,-1051,-4521,1.1
14,TMS14F1285P0006,45,UYON1801CS,8228,8452,2.1,2,6110,3785,224,-2325,-0.1
14,TMS14F1285P0017,46,UYON1801CS,16352,7416,4.4,NA,3888,3056,-8936,-832,NA
14,TMS14F1287P0008,47,UYON1801CS,16099,8619,6.1,8,6713,5903,-7480,-810,1.9
14,TMS14F1288P0008,48,UYON1801CS,6348,2441,1.1,1,5494,2969,-3907,-2525,-0.1
14,TMS14F1291P0003,49,UYON1801CS,17241,5304,3,NA,5538,3299,-11937,-2239,NA
14,TMS14F1291P0011,50,UYON1801CS,14368,4542,2.9,NA,4717,2569,-9826,-2148,NA
14,TMS14F1291P0012,51,UYON1801CS,9477,6043,4.7,8,10358,3681,-3434,-6677,3.3
14,TMS14F1292P0012,52,UYON1801CS,8374,5662,2.2,3,9251,7431,-2712,-1820,0.8
14,TMS14F1295P0012,53,UYON1801CS,10642,7130,1.1,2,10175,4444,-3512,-5731,0.9
14,TMS14F1297P0019,54,UYON1801CS,11431,4801,3.9,5,8755,4236,-6630,-4519,1.1
14,TMS14F1299P0007,55,UYON1801CS,9869,6183,4.4,4,10687,4549,-3686,-6138,-0.4
14,TMS14F1300P0002,56,UYON1801CS,13957,6724,2.7,NA,4580,3750,-7233,-830,NA
14,TMS14F1300P0008,57,UYON1801CS,9877,5870,4.2,5,14360,3681,-4007,-10679,0.8
14,TMS14F1301P0004,58,UYON1801CS,17808,8143,4.2,NA,8010,5972,-9665,-2038,NA
14,TMS14F1301P0013,59,UYON1801CS,10972,11954,5.6,10,11287,5000,982,-6287,4.4
14,TMS14F1303P0012,60,UYON1801CS,14387,4298,5.1,10,9384,3715,-10089,-5669,4.9
14,TMS14F1306P0008,61,UYON1801CS,10497,8528,4.1,8,10210,5833,-1969,-4377,3.9
14,TMS14F1306P0015,62,UYON1801CS,14004,5368,3.9,4,7662,3889,-8636,-3773,0.1
14,TMS14F1306P0020,63,UYON1801CS,13953,5900,2.8,4,6014,3056,-8053,-2958,1.2
14,TMS14F1310P0004,64,UYON1801CS,9818,4315,5.2,6,10084,2222,-5503,-7862,0.8
14,TMS14F1310P0015,65,UYON1801CS,17426,7757,3.3,NA,4146,4167,-9669,21,NA
14,TMS14F1311P0002,66,UYON1801CS,9209,2276,5.6,6,11109,3299,-6933,-7810,0.4
14,TMS14F1312P0003,67,UYON1801CS,11003,3433,3.9,5,7438,3264,-7570,-4174,1.1
15,IITA-TMS-IBA000070,1,UYUB1901CS,13700,5890,5.1,6,8385,2911,-7810,-5474,0.9
15,IITA-TMS-IBA30572,2,UYUB1901CS,7157,2950,2.8,3,14103,2349,-4207,-11754,0.2
15,IITA-TMS-IBA980581,3,UYUB1901CS,8702,8477,4.6,6,11397,4526,-225,-6871,1.4
15,IITA-TMS-IBA982101,4,UYUB1901CS,9807,6860,3.5,4,11500,5484,-2947,-6016,0.5
15,TMEB419,5,UYUB1901CS,6830,7827,3,4,12157,4651,997,-7506,1
15,TMS13F1021P0008,6,UYUB1901CS,10639,5894,4.1,5,10629,4198,-4745,-6431,0.9
15,TMS13F1049P0001,7,UYUB1901CS,8391,4337,2.2,2,11869,3771,-4054,-8098,-0.2
15,TMS13F1114P0001,8,UYUB1901CS,8147,5761,5.1,5,10010,3792,-2386,-6218,-0.0999999999999996
15,TMS13F1126P0003,9,UYUB1901CS,7277,2736,4.8,4,10897,1365,-4541,-9532,-0.8
15,TMS13F1182P0002,10,UYUB1901CS,10325,5582,3.8,6,9133,5146,-4743,-3987,2.2
15,TMS13F1304P0003,11,UYUB1901CS,12668,7087,2.5,3,8252,2198,-5581,-6054,0.5
15,TMS13F1315P0008,12,UYUB1901CS,7429,4454,2.9,2,11463,3594,-2975,-7869,-0.9
15,TMS13F1376P0018,13,UYUB1901CS,21375,6524,2.3,NA,7419,2771,-14851,-4648,NA
15,TMS13F1400P0001,14,UYUB1901CS,7230,3110,5.2,4,11497,2802,-4120,-8695,-1.2
15,TMS13F1461P0002,15,UYUB1901CS,8161,4820,6.1,6,11307,4427,-3341,-6880,-0.0999999999999996
15,TMS13F2061P0005,16,UYUB1901CS,9526,4631,3.4,4,11509,3208,-4895,-8301,0.6
15,TMS13F2207P0001,17,UYUB1901CS,10083,7111,3.8,6,10488,3708,-2972,-6780,2.2
15,TMS14F1001P0004,18,UYUB1901CS,9857,6279,3.5,4,9165,3573,-3578,-5592,0.5
15,TMS14F1013P0007,19,UYUB1901CS,10432,4646,2.9,4,9275,2292,-5786,-6983,1.1
15,TMS14F1014P0016,20,UYUB1901CS,8036,3903,2.3,2,9769,3073,-4133,-6696,-0.3
15,TMS14F1014P0017,21,UYUB1901CS,7732,4413,2.7,2,10143,2990,-3319,-7153,-0.7
15,TMS14F1016P0006,22,UYUB1901CS,11209,6473,5.1,16,8897,3042,-4736,-5855,10.9
15,TMS14F1019P0015,23,UYUB1901CS,8554,4175,3.1,3,8793,2010,-4379,-6783,-0.1
15,TMS14F1022P0003,24,UYUB1901CS,11463,4046,1.7,3,11210,2021,-7417,-9189,1.3
15,TMS14F1022P0006,25,UYUB1901CS,11043,5179,4.3,10,7983,2344,-5864,-5639,5.7
15,TMS14F1035P0004,26,UYUB1901CS,9214,5578,5.3,6,11827,1198,-3636,-10629,0.7
15,TMS14F1035P0007,27,UYUB1901CS,10302,5738,5.4,7,8343,2750,-4564,-5593,1.6
15,TMS14F1036P0007,28,UYUB1901CS,12964,9655,4.7,7,11816,4438,-3309,-7378,2.3
15,TMS14F1049P0001,29,UYUB1901CS,8639,4741,4.4,7,9685,3438,-3898,-6247,2.6
15,TMS14F1098P0013,30,UYUB1901CS,6682,3435,5.2,5,10276,1667,-3247,-8609,-0.2
15,TMS14F1120P0003,31,UYUB1901CS,4975,2502,5,5,11832,3490,-2473,-8342,0
15,TMS14F1125P0010,32,UYUB1901CS,8901,4207,4,4,11972,2958,-4694,-9014,0
15,TMS14F1131P0001,33,UYUB1901CS,9915,3563,3.8,3,10478,1323,-6352,-9155,-0.8
15,TMS14F1146P0002,34,UYUB1901CS,13027,4359,3.1,NA,4496,2406,-8668,-2090,NA
15,TMS14F1159P0003,35,UYUB1901CS,9697,4441,3.4,4,9687,2167,-5256,-7520,0.6
15,TMS14F1194P0002,36,UYUB1901CS,15391,7707,2.7,NA,6044,3656,-7684,-2388,NA
15,TMS14F1195P0004,37,UYUB1901CS,7816,4235,2,2,10699,2802,-3581,-7897,0
15,TMS14F1195P0005,38,UYUB1901CS,7408,3151,4.9,5,15045,2177,-4257,-12868,0.0999999999999996
15,TMS14F1196P0003,39,UYUB1901CS,9670,4564,2.1,2,9670,1875,-5106,-7795,-0.1
15,TMS14F1208P0007,40,UYUB1901CS,8083,1884,6.2,7,12040,1365,-6199,-10675,0.8
15,TMS14F1223P0007,41,UYUB1901CS,11835,3619,4.8,4,8178,1646,-8216,-6532,-0.8
15,TMS14F1224P0004,42,UYUB1901CS,4646,1533,5.4,2,12435,875,-3113,-11560,-3.4
15,TMS14F1262P0002,43,UYUB1901CS,8263,7073,4.7,5,12945,3719,-1190,-9226,0.3
15,TMS14F1278P0003,44,UYUB1901CS,10058,3997,2.2,3,7819,1969,-6061,-5850,0.8
15,TMS14F1285P0006,45,UYUB1901CS,8049,5962,2.2,2,6007,3385,-2087,-2622,-0.2
15,TMS14F1285P0017,46,UYUB1901CS,14468,6661,4.6,NA,3668,1719,-7807,-1949,NA
15,TMS14F1287P0008,47,UYUB1901CS,13742,6121,6.1,8,6669,3938,-7621,-2731,1.9
15,TMS14F1288P0008,48,UYUB1901CS,6795,3388,1.2,1,5308,1969,-3407,-3339,-0.2
15,TMS14F1291P0003,49,UYUB1901CS,15226,3654,3.1,NA,5115,1188,-11572,-3927,NA
15,TMS14F1291P0011,50,UYUB1901CS,12529,4266,3,NA,4101,1562,-8263,-2539,NA
15,TMS14F1291P0012,51,UYUB1901CS,8565,1570,5.3,8,9672,1042,-6995,-8630,2.7
15,TMS14F1292P0012,52,UYUB1901CS,7925,6299,2.5,3,9470,5031,-1626,-4439,0.5
15,TMS14F1295P0012,53,UYUB1901CS,10973,2903,1.3,2,10010,1969,-8070,-8041,0.7
15,TMS14F1297P0019,54,UYUB1901CS,9653,7760,4.1,5,8311,5042,-1893,-3269,0.9
15,TMS14F1299P0007,55,UYUB1901CS,8383,2727,4.9,4,10012,3406,-5656,-6606,-0.9
15,TMS14F1300P0002,56,UYUB1901CS,12458,3702,2.9,NA,4315,3500,-8756,-815,NA
15,TMS14F1300P0008,57,UYUB1901CS,9274,4783,4.7,5,13154,3344,-4491,-9810,0.3
15,TMS14F1301P0004,58,UYUB1901CS,15008,6360,4.3,NA,7218,4594,-8648,-2624,NA
15,TMS14F1301P0013,59,UYUB1901CS,8472,6321,5.6,10,11186,2979,-2151,-8207,4.4
15,TMS14F1303P0012,60,UYUB1901CS,11852,8229,5.1,10,9110,4854,-3623,-4256,4.9
15,TMS14F1306P0008,61,UYUB1901CS,9435,3373,4.5,8,9346,2021,-6062,-7325,3.5
15,TMS14F1306P0015,62,UYUB1901CS,11929,6372,4.3,4,8166,4042,-5557,-4124,-0.3
15,TMS14F1306P0020,63,UYUB1901CS,13874,6167,2.9,4,5983,3208,-7707,-2775,1.1
15,TMS14F1310P0004,64,UYUB1901CS,8707,2344,6,6,9388,1573,-6363,-7815,0
15,TMS14F1310P0015,65,UYUB1901CS,15326,7352,3.5,NA,3769,2292,-7974,-1477,NA
15,TMS14F1311P0002,66,UYUB1901CS,8071,4818,6.1,6,10345,2802,-3253,-7543,-0.0999999999999996
15,TMS14F1312P0003,67,UYUB1901CS,9617,6777,4.2,5,7318,3292,-2840,-4026,0.8
16,IITA-TMS-IBA000070,1,UYUM1801CS,14096,12787,4.5,6,7645,5867,-1309,-1778,1.5
16,IITA-TMS-IBA30572,2,UYUM1801CS,7567,8286,4,3,11377,4792,719,-6585,-1
16,IITA-TMS-IBA980581,3,UYUM1801CS,8221,10270,4.6,6,10100,4979,2049,-5121,1.4
16,IITA-TMS-IBA982101,4,UYUM1801CS,8975,11296,3.4,4,9745,5908,2321,-3837,0.6
16,TMEB419,5,UYUM1801CS,7246,10559,3.8,4,9713,5867,3313,-3846,0.2
16,TMS13F1021P0008,6,UYUM1801CS,9386,12816,3.9,5,8828,5562,3430,-3266,1.1
16,TMS13F1049P0001,7,UYUM1801CS,7546,7662,2.2,2,9988,5385,116,-4603,-0.2
16,TMS13F1114P0001,8,UYUM1801CS,7175,9406,4.7,5,9188,6097,2231,-3091,0.3
16,TMS13F1126P0003,9,UYUM1801CS,6296,8086,3.6,4,9184,1865,1790,-7319,0.4
16,TMS13F1182P0002,10,UYUM1801CS,9023,14105,3.5,6,7926,8264,5082,338,2.5
16,TMS13F1304P0003,11,UYUM1801CS,10462,13071,2.4,3,7357,6073,2609,-1284,0.6
16,TMS13F1315P0008,12,UYUM1801CS,7166,9765,2.4,2,9574,5542,2599,-4032,-0.4
16,TMS13F1376P0018,13,UYUM1801CS,17132,18144,2.1,NA,6963,4729,1012,-2234,NA
16,TMS13F1400P0001,14,UYUM1801CS,7151,6688,4.3,4,9765,3958,-463,-5807,-0.3
16,TMS13F1461P0002,15,UYUM1801CS,6797,9691,5.5,6,10187,5972,2894,-4215,0.5
16,TMS13F2061P0005,16,UYUM1801CS,8766,11640,3,4,9797,5194,2874,-4603,1
16,TMS13F2207P0001,17,UYUM1801CS,9320,8355,3.4,6,8652,4965,-965,-3687,2.6
16,TMS14F1001P0004,18,UYUM1801CS,8554,12160,3.3,4,7828,5368,3606,-2460,0.7
16,TMS14F1013P0007,19,UYUM1801CS,8389,15761,2.8,4,7993,4302,7372,-3691,1.2
16,TMS14F1014P0016,20,UYUM1801CS,7221,8363,2.3,2,8418,4167,1142,-4251,-0.3
16,TMS14F1014P0017,21,UYUM1801CS,6598,9764,2.7,2,8172,6458,3166,-1714,-0.7
16,TMS14F1016P0006,22,UYUM1801CS,9806,10177,4.7,16,8108,4215,371,-3893,11.3
16,TMS14F1019P0015,23,UYUM1801CS,7432,13922,3,3,7650,6521,6490,-1129,0
16,TMS14F1022P0003,24,UYUM1801CS,9964,11612,1.7,3,9738,6500,1648,-3238,1.3
16,TMS14F1022P0006,25,UYUM1801CS,10237,8804,3.9,10,7207,2167,-1433,-5040,6.1
16,TMS14F1035P0004,26,UYUM1801CS,10063,13321,5.2,6,10780,3840,3258,-6940,0.8
16,TMS14F1035P0007,27,UYUM1801CS,8100,8873,4.9,7,7769,3486,773,-4283,2.1
16,TMS14F1036P0007,28,UYUM1801CS,11126,17930,4.7,7,10757,8264,6804,-2493,2.3
16,TMS14F1049P0001,29,UYUM1801CS,7878,10140,3.8,7,8401,5250,2262,-3151,3.2
16,TMS14F1098P0013,30,UYUM1801CS,5996,8260,4.2,5,9158,6125,2264,-3033,0.8
16,TMS14F1120P0003,31,UYUM1801CS,4196,9982,4.6,5,10204,10201,5786,-3,0.4
16,TMS14F1125P0010,32,UYUM1801CS,8573,13858,3.5,4,10303,5344,5285,-4959,0.5
16,TMS14F1131P0001,33,UYUM1801CS,7857,16652,3.5,3,9138,3854,8795,-5284,-0.5
16,TMS14F1146P0002,34,UYUM1801CS,10397,11267,2.9,NA,4390,4854,870,464,NA
16,TMS14F1159P0003,35,UYUM1801CS,8525,12048,3.3,4,8297,4854,3523,-3443,0.7
16,TMS14F1194P0002,36,UYUM1801CS,12276,12323,2.6,NA,5761,4486,47,-1275,NA
16,TMS14F1195P0004,37,UYUM1801CS,6691,8836,2,2,9358,3490,2145,-5868,0
16,TMS14F1195P0005,38,UYUM1801CS,8745,15091,4.8,5,13459,5118,6346,-8341,0.2
16,TMS14F1196P0003,39,UYUM1801CS,8153,14333,2.1,2,8180,3542,6180,-4638,-0.1
16,TMS14F1208P0007,40,UYUM1801CS,8305,11089,5.4,7,10717,3757,2784,-6960,1.6
16,TMS14F1223P0007,41,UYUM1801CS,9505,12291,4.4,4,7684,3077,2786,-4607,-0.4
16,TMS14F1224P0004,42,UYUM1801CS,4872,8220,4.2,2,10429,2285,3348,-8144,-2.2
16,TMS14F1262P0002,43,UYUM1801CS,8224,13963,4.2,5,11110,5722,5739,-5388,0.8
16,TMS14F1278P0003,44,UYUM1801CS,8819,10586,2,3,6707,3948,1767,-2759,1
16,TMS14F1285P0006,45,UYUM1801CS,6492,7119,2.2,2,5310,5500,627,190,-0.2
16,TMS14F1285P0017,46,UYUM1801CS,11677,15644,4.4,NA,3722,4347,3967,625,NA
16,TMS14F1287P0008,47,UYUM1801CS,10344,7134,6.1,8,6790,4635,-3210,-2155,1.9
16,TMS14F1288P0008,48,UYUM1801CS,5965,5279,1.1,1,4701,3469,-686,-1232,-0.1
16,TMS14F1291P0003,49,UYUM1801CS,12625,12474,2.9,NA,4833,4156,-151,-677,NA
16,TMS14F1291P0011,50,UYUM1801CS,10004,10902,2.9,NA,3693,2542,898,-1151,NA
16,TMS14F1291P0012,51,UYUM1801CS,8293,12670,4.5,8,8587,6125,4377,-2462,3.5
16,TMS14F1292P0012,52,UYUM1801CS,6547,11968,2.5,3,8414,8719,5421,305,0.5
16,TMS14F1295P0012,53,UYUM1801CS,9252,10475,1.2,2,8617,4438,1223,-4179,0.8
16,TMS14F1297P0019,54,UYUM1801CS,7066,10161,4,5,7458,5049,3095,-2409,1
16,TMS14F1299P0007,55,UYUM1801CS,7374,9751,4.2,4,8798,4740,2377,-4058,-0.2
16,TMS14F1300P0002,56,UYUM1801CS,9962,11465,2.7,NA,4168,5125,1503,957,NA
16,TMS14F1300P0008,57,UYUM1801CS,9655,12127,4,5,11452,7604,2472,-3848,1
16,TMS14F1301P0004,58,UYUM1801CS,12361,17391,3.9,NA,7096,10375,5030,3279,NA
16,TMS14F1301P0013,59,UYUM1801CS,7210,11459,5.5,10,10154,6552,4249,-3602,4.5
16,TMS14F1303P0012,60,UYUM1801CS,9286,7788,5,10,8591,4403,-1498,-4188,5
16,TMS14F1306P0008,61,UYUM1801CS,9258,11755,3.8,8,8126,5885,2497,-2241,4.2
16,TMS14F1306P0015,62,UYUM1801CS,8711,16766,4.2,4,7942,4729,8055,-3213,-0.2
16,TMS14F1306P0020,63,UYUM1801CS,10632,11382,2.8,4,5495,4410,750,-1085,1.2
16,TMS14F1310P0004,64,UYUM1801CS,8523,16940,5.1,6,8478,6924,8417,-1554,0.9
16,TMS14F1310P0015,65,UYUM1801CS,13916,12707,3.2,NA,3642,4531,-1209,889,NA
16,TMS14F1311P0002,66,UYUM1801CS,7821,6898,5.5,6,9056,5569,-923,-3487,0.5
16,TMS14F1312P0003,67,UYUM1801CS,7263,11860,4,5,6744,8639,4597,1895,1
